JYUTPING	IPA	CHAR
aa1	∅a55	一{(語)又音，弱讀},鴉{烏鴉，鴉片},啞{同呀字；咿啞},啊{表驚訝},呀{嘆詞；象聲詞},吖{吖嗪，吖啶黃；語氣詞},丫{丫頭}
aa2	∅a35	啊{表疑問},嗄{同啊字},啞{啞巴，聾啞}
aa3	∅a33	亞{亞洲；近指代詞，這，弱讀爲[∅ɐ33/∅ə33]，又作阿字，本字箇},阿{阿哥；近指代詞，這，弱讀爲[∅ɐ33/∅ə33]，又作亞字，本字箇},錒,氬,掗{掗賈},婭,埡,啊{表讚歎}
aa4	∅a21	啊{表惋惜}
aa6	∅a22	啊{句首表應答或醒悟，句末表驚歎}
aai1	∅ai55	哎{哎喲，哎呀},挨{挨近},埃{(白)塵埃；埃及},噯{同哎字},唉{應答聲；唉聲嘆氣}
aai2	∅ai35	欸{欸乃}
aai3	∅ai33	嗌{噎也；〈語〉罵，～人，捱～，此義常用；喊叫，此義罕用；一說本字呝/呃/噫},餲{(又)},隘{隘口，險隘}
aai6	∅ai22	唉{表惋惜}
aak3	∅ak3	軛{牛軛；手～，手鐲，俗字鈪},鈪{粵字，手～，手鐲，本字軛},軶
aan2	∅an35	俺{(又)}
aan3	∅an33	晏{晚也，起得～，起得晚，～晝，中午，食～，吃午飯}
aang1	∅aŋ55	罃{長頸瓶},罌{罌粟；瓦罐，～煲鑊頭，炊具的總稱}
aap3	∅ap3	壓{(又)},鴨,押{抵押，押送}
aat3	∅at3	咹{吃},餲{食物腐臭變味},閼{閼塞},遏,胺{胺臭},猰,揠,壓{壓扁，氣壓},堨{阻塞；堤堰}
aau1	∅au55	凹{凹陷，下凹},嗷{(語)嚎聲}
aau2	∅au35	拗{(文)}
aau3	∅au33	坳{(文)地名，高峯坳},𥁒,靿{靴靿},詏{(文)},拗{(文)}
ai1	∅ɐi55	哎{(又)},矮{(白)},唉{(又)}
ai2	∅ɐi35	矮
ai3	∅ɐi33	嫕,翳{遮蔽；〈語〉～氣，窩火，～滯，胃口差},縊,瞖{目瞖},曀
ai6	∅ɐi22	唉{(又)}
ak1	∅ɐk5	偓,齷{齷齪},餩{打嗝聲；打（閡[hɐk2]）～，打嗝，又作呃字},阨,蚅{烏蠋；〈語〉～虵[ɛ22]，蛤蚧，擬蛤蚧叫聲得名},苊,渥,搤{同扼字},握{握手，掌握},扼,戹,幄,喔{雞啼聲},啞{啞然失笑},呝{同呃字},呃{呃逆；打（閡[hɐk2]）～，打嗝，又作餩字},厄
am1	∅ɐm55	唵{唵嘛呢叭咪吽},鵪{鵪鶉},諳,菴{菴藹},腤,盦,庵{尼姑庵},广{同庵字}
am2	∅ɐm35	咹{同唵字},黯,罯{魚網},揞{用手捂，與搕對轉},埯{小坑；量詞},垵{同埯字；地名，新垵（在福建）},唵{含}
am3	∅ɐm33	暗,闇{愚闇},窨{(白)～熟，捂熱}
am4	∅ɐm21	唵{(語)含，童語}
an1	∅ɐn55	恩{恩德，報恩},蒽
an3	∅ɐn33	㥯{(白)度量；分～，分寸，～住食/買，有節制地吃/買}
ang1	∅ɐŋ55	鶯{黃鶯}
ang2	∅ɐŋ35	哽{～腳，硌腳}
ang3	∅ɐŋ33	嗯{(語)使勁憋，～屎，拉屎，象聲或啊嗯的合音}
ap1	∅ɐp5	姶,腌{腌臢（不潔）},罯{覆蓋},浥{(語)～汁，陰暗潮溼},搕{捂、敷，與揞對轉}
at1	∅ɐt5	一{(語)弱讀},扤{用力塞，本字壓},壓{(白)用力塞，俗字扤}
au1	∅ɐu55	區{姓},鷗,謳,甌,熰{旱熱},毆{毆打，讀同歐},歐
au2	∅ɐu35	嘔{嘔吐},𠙶,塸
au3	∅ɐu33	慪{慪氣},熰{煖},漚{漚肥}
baa1	pa55	䰾,豝,蚆,葩{奇葩},芭,舥,羓,粑,笆,疤{傷疤},爸{爸[pa21]爸，阿爸},巴{巴掌，尾巴},峇{峇厘島},岜,夿{奤夿屯},吧{酒吧，網吧},叭{象聲詞；喇叭；唵嘛呢叭咪吽}
baa2	pa35	㞎{(又)㞎[pa21]～，屎},靶,鈀{金屬元素，符號Pd},把{把握}
baa3	pa33	垻{平川},霸,灞,欛{刀～，刀柄},壩{堤壩}
baa4	pa21	吧{(語)詞綴，落雨～～，雨嘩嘩地下}
baa6	pa22	吧{語氣詞},罷
baai1	pai55	䠋{蹟䠋},掰{掰開}
baai2	pai35	捭,襬{下襬},擺{擺放}
baai3	pai33	㗑,湃,拜
baai6	pai22	唄{唄唱，梵唄},稗,敗
baak1	pak5	嚗{(白)象聲詞，～～聲；湢[pɛk5]～筒，唧水筒；曬～～，陽光猛烈}
baak3	pak3	伯,蘗{(文)},薜{當歸；山麻},百,檗{(文)},柏{(文)},佰
baak6	pak2	僰,鮊,踣,蔔{蘿蔔},菔{(又)},白,帛{玉帛，布帛},匐{(又)}
baan1	pan55	㿀,𨭉,頒,癍,瘢,班,斑,攽
baan2	pan35	坂,阪,闆{老闆},鈑,蝂,舨{舢舨},版,板{黑板，石板},昄,扳{扳手}
baan3	pan33	𢲔{同𢴬字},𢴬{摔、摔打，一說本字拌}
baan6	pan22	埿{同湴字，淤泥，爛～田，爛泥田},𦝤,辦,瓣,湴{淤泥，爛～田，爛泥田，又作埿字},扮
baang1	paŋ55	乓{(白)},嗙{(語)象聲詞；詞綴，聾～～，聾貌}
baang4	paŋ21	嘭{(語)象聲詞，呯[peŋ21]呤[leŋ21]～啷[laŋ21]，劈哩啪啦}
baang6	paŋ22	㼞{㼚屬},甏{甕}
baat3	pat3	八{(文)～～來，猜碼口令，數字八},朳,捌{無齒杷；八字大寫},扒{扒皮},哵{鳥聲}
baat6	pat2	坺{同墢/垡字；塵貌},鮁,魃,鈸{銅鈸，鐃鈸},跋{題跋，跋扈},菝,茇{草根},胈,拔{拔河，選拔},妭
baau1	pau55	包{(文)包工，包辦，包公，麪包},鮑{鮑魚；姓},褒{(白)褒獎，褒貶},苞{(文)},胞{(文)細胞},枹{枹樹},孢{(文)}
baau2	pau35	飽{(文)飽和，飽學}
baau3	pau33	爆{(文)爆炸；爆料，爆棚（滿座）；〈語〉漂亮},趵{(文)},豹{(文)}
baau6	pau22	骲{(文)},齙{(文)}
bai1	pɐi55	㝿{(又)},𨃅{瘸，又作跛字，本字䠋},鎞{釵},跛{(訓)瘸，本字䠋},䠋{(白)瘸，俗字跛}
bai2	pɐi35	稗{(又)}
bai3	pɐi33	背{(語)～時、～竅，倒黴，又作閉時、閉竅/巧，官話借詞},閉{關閉，閉幕},蔽{(書)}
bai6	pɐi22	坒,陛{陛下},鐾{鐾刀布，鐾刀},薜{薜荔},狴,梐,斃{(書)},敝{(書)},弊{(書)作弊；糟糕},幣{人民幣，錢幣}
bak1	pɐk5	北
bam1	pɐm55	泵{(外)水泵，英語pump}
bam2	pɐm35	渢{(語)重物落水聲},韸{(語)鴨韸[pɐm21]～，鴨的嗉胞}
bam4	pɐm21	韸{(語)響～～，轟轟響；呯[peŋ21]呯[peŋ21]～～，擬炮聲；鴨～韸[pɐm35]，鴨的嗉胞}
bam6	pɐm22	𦝤{(語)虛胖}
ban1	pɐn55	儐{尊敬},鬢{(常)鬢角，兩鬢，讀同賓},髕{髕骨，讀同賓},鑌,錛,邠,賓,賁{虎賁；姓},豳,臏{同髕字；孫臏},繽,玢{玉名},犇,濱,浜{同濱字},汃{同邠字},殯{(常)出殯，讀同賓},檳{檳榔},栟{栟茶},斌,攽{(又)},彬,嬪{(常)嬪妃，讀同賓},奔{奔跑；投奔}
ban2	pɐn35	稟{稟告，回稟}
ban3	pɐn33	儐{儐相},鬢{鬢角，兩鬢},逩,殯{出殯},擯,捹{手亂貌；〈語〉旋轉，～螺[lɔ55]螺[lɔ55]，團團轉，～孖辮，梳辮子}
ban6	pɐn22	倴,笨,坌{灰塵；聚集}
bang1	pɐŋ55	嗙{喝聲；嗙喻},鏰,蹦,繃{繃帶},綳{同繃字},絣{振繩墨},祊,崩{崩塌，山崩},嘣
bang2	pɐŋ35	綳{(語)},繃{(語)～耿，古板}
bang3	pɐŋ33	堋{喪葬下土}
bang4	pɐŋ21	嘣{(語)象聲詞，～一聲}
bang6	pɐŋ22	䨻,𠾴{同唪字},唪{(語)冚～唥，全部，弱讀爲[pɐ22/pə22]，一說本字𠊧/朋},凭{倚靠}
bap1	pɐp5	卟{(語)用力甩、糊上；耷拉、垂下；摔落聲}
bap6	pɐp2	卟{(語)～～聲，卟卟響；跌落聲；心跳聲}
bat1	pɐt5	不{不能，不鏽鋼},𢳂{舀，一說本字拂},鈈,蹕,蓽,篳,筆,畢,珌{(又)},滭,泌{泌瀄},嗶,咇{咇㘉}
bat6	pɐt2	弼,邲{古地名；姓},苾{苾苾},拂{通弼字}
bau6	pɐu22	䏽{肉醬；瘻～，不整潔、臃腫}
be1	pɛ55	啤{啤酒，德語bier},屄{(白)女陰}
be2	pɛ35	㞎{㞎[pɛ21]～，屎，童語}
be4	pɛ21	疤{(語)痲～，痲子}
be6	pɛ22	唄{語氣詞}
bek1	pɛk5	湢{(白)～嚗[pak5]筒，唧水筒}
ben1	pɛn55	砭{(白)},邊{(白)一/半～，半邊，破～，剖開兩半}
ben2	pɛn35	匾{(白)},貶{(白)貶值，貶低},揙{(白)打},扁{(白)扁菜；扁桃體；打，又作揙字}
beng2	pɛŋ35	鉼{餅狀金屬塊},餅
beng3	pɛŋ33	柄{(白)名詞，刀～}
beng6	pɛŋ22	病
bet1	pɛt5	泌{(白)象聲詞，擠射，將膿～出去，引申爲驅趕，將人～出去；～瀄，同義複用，引申爲排斥、開除}
bet3	pɛt3	八{(白)八卦，八仙；～匹馬，猜碼口令，數字八},捌{(白)八字大寫}
bet6	pɛt2	咇{(白)喃[nam55]～～，囉嗦、嘮叨；鴨～～，鴨，童語，又作吡字},跋{(白)罕讀},癟{(白)腍～～，軟貌},泌{(白)溼～～，溼貌，爛～～，稀爛},拔{(白)罕讀},坺{(白)罕讀}
beu1	pɛu55	包{(白)打包，麻包，皮包，包糉},苞{(白)},胞{(白)胞胎},孢{(白)}
beu2	pɛu35	飽{(白)食飽，飽嗮}
beu3	pɛu33	爆{(白)爆炸},趵{(白)},豹{(白)虎豹}
beu6	pɛu22	骲{(白)用力擠},齙{(白)齙牙}
bi1	pi55	卑,鵯,陂{山陂，陂塘},裨{裨益},蓖{蓖麻},萆{萆薢},羆,碑,椑{椑柿},悲,屄{(文)吹牛屄（口語用車大奅、鑿大）},啤{(語)詞綴，青～～，青青的}
bi2	pi35	䠋{同髀字},髀{大腿},譬{(訓)訓讀比},芘{有機化合物},舭,肶,秕{秕子},畀{給},沘,比{比較；比鄰，古讀去聲},媲{(訓)媲美又作比美，訓讀比},妣,吡{吡啶，吡咯},俾{使}
bi3	pi33	匕,閉{(又)},鉍,鄪,邲{好貌},轡,賁{賁臨},費{費縣},詖,芘{通庇字},臂,肸{古地名},秘{同祕字},祕{祕書，祕密},痺{痹的俗字},痹{麻痹},潷{擋住渣滓，把液體倒出},泌{分泌，泌尿；地名，泌陽（在河南）},毖,庇
bi6	pi22	備{準備，備用},鼻{鼻子，鼻涕},髲,鞴,鞁,陛{(又)},鎞{同篦字},避,贔,被{被動},蔽{(習)隱蔽},糒,篦{篦子，篦頭},箅{箅子},箄{漁具},睥{睥睨，讀同婢},狴{(又)},梐{(又)},斃{(習)槍斃，斃命},敝{(習)凋敝，敝人},憊{疲憊，讀同備，古讀蒲拜切},弊{(習)作弊},庳{房屋矮小；低窪；有庳},幣{(又)},婢{婢女},奰,埤{低窪潮溼地；埤堄},坒{(又)},嚊{喘息聲}
bik1	pek5	偪,鰏,逼,迫{(罕)訓讀逼},躄,襞,碧,皕,璧,煏{用火烤},湢{湢測，湢浴},愎,愊,壁
bin1	pin55	煸{(又)},鯿{鯿魚},鞭,邊{旁邊，邊緣},辮{髮辮，辮子},蝙{(又)},萹{萹蓄},緶{通辮字},籩,砭,甂{打～爐，打火鍋}
bin2	pin35	便{(白)順便，隨便},貶{(文)},褊{褊狹},窆,碥,揙{(文)},扁{(文)},匾{(文)}
bin3	pin33	變
bin6	pin22	便{方便，便利；邊、面，東～、兩～，又作邊字},𨚕,邲{水名},邊{(語)左/右～，左/右邊，又作便字},辯,辨,苄,汴,昪,抃,忭,弁,卞
bing1	peŋ55	乒,栟{栟柑，栟櫚},掤,并{并州},冰,兵
bing2	peŋ35	丙,鞆,邴,蛃,秉,炳,昺,屏{屏除，屏息}
bing3	peŋ33	並{(又)},迸{迸裂},竝{(又)},柄{(文)量詞，把},摒{摒棄，摒除},并{同併字，合併；〈又〉同並字，並且},併{合併，併入}
bing4	peŋ21	呯{(語)象聲詞，～呤[leŋ21]嘭[paŋ21]啷[laŋ21]，劈哩啪啦，～～韸[pɐm21]韸[pɐm21]，擬炮聲}
bing6	peŋ22	並{並且，並行},竝{並的本字},并{同並字，並且}
bit1	pit5	佖,鉍{(又)},觱,珌,必,咇{咇茀}
bit3	pit3	彆{彆扭},鼈,鱉{魚鱉；吹風～，眼鏡蛇},蹩{(常)蹩腳，後字調類化},憋
bit6	pit2	別{離別；區別},馝,蹩{蹩腳},苾{菜名},癟{癟陷；癟三}
biu1	piu55	䅺{稻田秀出者；〈語〉冒出，～芽},驫,驃{黃白色的馬},飈,飇,飆{狂飆，飆車，發飆},颮{同飆字},鑣,鏢,錶{手錶},藨,蔈,臕{肥臕},膘{肥膘},穮{除草},瘭,猋{犬奔貌；通飆字},熛{火飛},瀌{雨雪瀌瀌},滮{水流貌；〈語〉迸射},標,杓{勺子柄},摽{揮去；拋棄},彪,幖,儦
biu2	piu35	俵,裱,表{表面},脿,婊
biu3	piu33	嫑
bo1	pɔ55	啵,𨨏,菠{菠菜，菠蘿},般{般若},磻{繳矢所用石塊},玻{玻璃},波{波浪；〈外〉球，～鞋，英語ball},嶓
bo2	pɔ35	㝿,跛{跛足}
bo3	pɔ33	噃{粵字，語氣詞，本地用喎，噃已不用，一說喎本爲噃的弱讀},蕃{吐蕃},簸{〈名〉簸箕；〈動〉簸米，簸穀},播
bo6	pɔ22	薄{薄荷，又作蔢𦽅}
bok1	pɔk5	㩧{敲，～一棍，與𢷕旁轉},𦢊{泡、皰，又作泡/㿺字},泡{(語)泡，豆腐～；皰，又作𦢊/㿺字},欂{(語)又音，～碌，柚子},樸{(白)又音，～碌，柚子},嚗{(白)象聲詞，～～聲，脆裂聲；～佬，土包子，一說本字儤/𢖔/𧟵},㿺
bok3	pɔk3	㬍{暴也；～籮，笸籮；〈語〉阿～，這段時間},駁,餺,鎛,膊{胳膊，肩膊；～頭，肩膀，～布，挑擔時肩上墊布},縛{(又)},猼{猼訑},欂{欂櫨},搏,壆{壟},嚗{象聲詞；怒聲},博,剝,亳,䭦{同餺字}
bok6	pɔk2	帛{(又)},魄{(又)落魄，又作落泊/落薄},雹{冰雹},鉑,薄{厚薄},舶{(文)},箔,礴,礡,濼{同泊字},泊{(文)淡泊，漂泊}
bong1	pɔŋ55	乓{(文)},𠳐,邦,縍,浜{小河溝；沙家浜},梆,幫
bong2	pɔŋ35	嗙{自誇；吹牛},髈{同膀字},謗{(又)},蒡{牛蒡},膀{肩膀，光膀子（口語用打赤肋）},綁,牓{同榜字；門牓},榜{張榜，榜樣}
bong3	pɔŋ33	搒{划船}
bong4	pɔŋ21	𩐨{(語)敲～～，敲大鑼}
bong6	pɔŋ22	傍{依傍},鎊,謗{誹謗，謗議},磅{過磅；～水，交錢},棓{棍、杖，後作棒},棒{棍棒，棒球},塝
bot1	pɔt5	𠼭{(又)},𡀖{(又)}
bot6	pɔt2	𦤣{(語)屁聲}
bu1	pu55	峬,鈽,逋,褒{(文)},煲{瓦煲，煲湯，一說本字釜/缹/鍑/褒，另一說英語boil},晡
bu2	pu35	保,𨰻,鴇,褓{襁褓},補,葆,寶,孬{(又)},堡,埔{黄埔，大埔}
bu3	pu33	佈{佈置，佈告},怖{恐怖},布{布匹，紅布},報,儤
bu6	pu22	哺{(又)},鵏,部,虣,蔀,菢{孵},簿,爆{(又)爆炸，讀同暴},瀑{水名，瀑河；〈常〉瀑布},步,曝{(常)曝曬，曝光},暴{暴露，暴力，殘暴},捕{(又)},埠{埠頭，船埠；地名，石埠},埗{同埠字；地名用字}
bui1	pui55	杯,誖{(語)吹捧、哄},盃{獎盃},桮
bui3	pui33	揹{同背字，揹負，揹槍},鋇,邶,輩,貝,褙,背{背脊，後背},狽,浿,梖
bui6	pui22	孛{彗星},鐾{(又)},誖{言亂},苝,背{背書，耳背},焙{焙乾},悖
buk1	pʊk5	卜{(又)},欂{(語)～碌，柚子，本字樸},樸{(白)～碌，柚子，俗字欂/卜},卟{(又)卟吩}
buk6	pʊk2	伏{(白)趴，～喺檯，～住},𦢊{(語)風～，風疹},鏷,轐,蹼,襆{(又)},穙{穀積也；〈量〉把、串，兩～，兩串，一～稑[lʊk2]，一嘟嚕，與唪對轉},瀑{瀑布},濮,樸{木名},曝{曝曬，曝光},暴{同曝字},幞{(又)}
bun1	pun55	搬,般{搬運}
bun2	pun35	本,苯,畚
bun3	pun33	半,靽
bun6	pun22	伴{伴侶，伙伴},絆,畔{湖畔，江畔},泮{同畔字；地名，泮塘村（在橫縣），泮塘（在賓陽縣）},柈{柈子},拌{攪拌，拌勻}
bung1	pʊŋ55	韸{(語)脹～～，脹鼓鼓，或與繃相關；（蒼蠅）趴，～住}
bung2	pʊŋ35	捧{(白)},菶{菶菶},甭,琫,玤,渢{(語)重物落水聲}
bung4	pʊŋ21	韸{(語)～～聲，嘭嘭響}
bung6	pʊŋ22	䭰,𩗴,埲{塵起貌},唪{大笑也；〈量〉簇、串，一～葡萄；一～哢，一嘟嚕，與穙對轉，疑本字菶茸，另一說與朋相關}
but1	put5	𠼭{同𡀖字},𡀖{汽笛聲；～～車，汽車，童語}
but3	put3	砵,鱍,鉢{鉢盂，衣鉢},缽{同鉢字}
but6	put2	勃,𦤣{臭敗氣},𡋯{𡋯土},鵓,馞,餑{麪餑},襏,荸{荸薺（源自葧臍，口語用馬蹄）},脖,潑{(又)活潑，讀同撥，又或前字順同化},渤,浡,桲,撥{撥開，點撥},孛{同勃字；姓},哱
caa1	tʃʰa55	叉,蹅{踏},杈{枝杈},扠,差{差別；〈又〉參差，俗讀},喳{象聲詞，擬人聲，嘁嘁喳喳，打喳喳}
caa2	tʃʰa35	鑔{小鈸}
caa3	tʃʰa33	䟕,詫,衩,汊,岔{岔路},奼,侘
caa4	tʃʰa21	垞,𥻗,餷,茶,茬{麥茬},苴{枯草},槎{木筏},查{調查},搽{搽藥，搽粉},嵖
caai1	tʃʰai55	偲{多才},釵,猜,搋{搓揉，～麪},差{出差}
caai2	tʃʰai35	䐆{(白)牛～，牛下水},踹{踩},踩{踩踏，本字跐；〈語〉禽類交配},跴{同踩字},跐{(白)俗字踩}
caai3	tʃʰai33	嘬{咬；吃},蠆,瘥{病癒}
caai4	tʃʰai21	儕{同儕},豺{豺狼},茈{茈胡},柴,喍
caak1	tʃʰak5	吒{叱吒},咤{叱咤，同叱吒}
caak3	tʃʰak3	㿭{皴},𤖴,蓛,粣{糉也},簎{刺也},箣,策,柵{柵欄},拺{馬鞭},拆{拆開},坼{裂開},冊,䜺{豆䜺}
caak6	tʃʰak2	賊{(罕)}
caam1	tʃʰam55	參{參加；〈又〉參差，俗讀},驂,辿{(又)},攙{攙扶},摻{摻雜，摻水；同攙字}
caam2	tʃʰam35	噆{銜也},黲,篸{撮箕，垃圾～},穇{穇子},朁,旵,摻{執持},憯,慘
caam3	tʃʰam33	儳{儳言},杉{杉樹，杉木；電燈～，電線杆},摻{鼓曲名},懺{懺悔},忏
caam4	tʃʰam21	儳{不齊},饞{嘴饞},鑱{(文)},讒{讒言},蠶{蠶蟲，蠶豆},蚕,攙{(文)},慚{慚愧},巉,劖{(文)}
caam5	tʃʰam24	㔆{割；剪；刺}
caan1	tʃʰan55	喰,餐,湌
caan2	tʃʰan35	䊲,鏟{(文)鏟車},產,滻,剷{(文)},剗
caan3	tʃʰan33	孱{孱頭},薒,羼,粲,璨,燦
caan4	tʃʰan21	慚{(常)俗讀},饞{(常)俗讀},讒{(常)俗讀},蠶{(常)俗讀},蚕{(又)},殘{殘疾，摧殘}
caang1	tʃʰaŋ55	撐{撐船，支撐},鐺{通鎗字，酒器；平底煎鍋},鎗{鐘聲也；酒器},罉{平底煎鍋，本字鐺},瞠,牚{同撐字},爭{(又)欠、差},橕
caang2	tʃʰaŋ35	橙{橙子，橙色，橙樹}
caang3	tʃʰaŋ33	撐{(又)撐場，硬撐（結實），讀同牚},鋥{鋥光，鋥亮；光～～，亮堂堂},牚{椅子牚}
caang4	tʃʰaŋ21	倀{獨立貌},棖,朾{朾螘},撜{同掁字},揨,掁
caap3	tʃʰap3	㮑{木折聲},𠝞{切物聲},鍤,臿{舂榖去皮},插{(文)},扱{插；挹取}
caat3	tʃʰat3	㔍{斷也；割斷聲},𩟔{添食也；〈語〉吃的俗稱，～飯，又作嚓字},獺{水獺，海獺，又作𤞠字},涮{(又)讀同刷/擦},欻{急促的聲響},檫,攃{摩擦，後作擦},擦{擦拭，摩擦，本字攃},察,嚓{象聲詞，啪嚓，喀嚓；〈語〉吃的俗稱，～飯，又作𩟔字},唰{象聲詞},刷{刷牙}
caau1	tʃʰau55	抄{(文)},𤙴{(文)},鈔{鈔票，現鈔；同抄字},摷{取}
caau2	tʃʰau35	㥮{(又)},炒{(文)},吵{(文)吵嚷，吵鬧，爭吵}
caau3	tʃʰau33	抄{(文)},肏{北方俗字，詈語，摹官話音，本字戳，肏本音入},耖
caau4	tʃʰau21	勦{輕捷也；勞也；〈語〉皺},巢{巢穴，鳥巢}
cai1	tʃʰɐi55	凄,郪,萋,淒{淒涼},棲{棲息；棲棲},栖{同棲字},悽{悽慘},妻
cai3	tʃʰɐi33	傺,磜{(又)},砌,瘛,沏{沏茶},切{一切}
cai4	tʃʰɐi21	薺{荸薺（源自葧臍，口語用馬蹄）；薺菜，讀同齊},齊{整齊，齊全；完，食～},鱭,鮆{刀魚，又作鱭字},蠐
cak1	tʃʰɐk5	厠{同廁字，厠足},測,惻,廁{廁足}
cak6	tʃʰɐk2	蠈,鰂{烏鰂，即烏賊},賊{做賊，賊佬}
cam1	tʃʰɐm55	侵,駸,諃,祲{(又)},棽,摻{(白)摻雜，摻水，讀同侵},嵾,參{參差，俗讀參加之參}
cam2	tʃʰɐm35	寑,鑔{(語)鑔聲，本字鍖},鍖{鍖銋；〈語〉鑔聲},磣,寢
cam3	tʃʰɐm33	吣{貓吣，胡吣},讖,譖{(又)},滲{(白)水滲透},浸{(語)量詞，層，與緝對轉},唚{同吣字，貓唚，胡唚；〈語〉～氣，臉色難看（晦氣義），疑本字謲}
cam4	tʃʰɐm21	噚,鱘,鐔{姓},鄩,覃{姓},蟫{蟫蟫},蕁{蕁麻，蕁麻疹，讀同尋，本字䕭/燅，本音潛},璕,爓{同燖字},燖,潯,潛{(又)},涔,沉{同沈字，沉沒},沈{沈沒},梣,撏{取也},岑{岑寂；姓},尋{尋找；走訪，～妗婆；〈語〉～日，昨日，昨晚的合音音變，合音後無晚義}
cam5	tʃʰɐm24	滲{(常)水滲透}
can1	tʃʰɐn55	伸{(白)～手，～懶腰，～直，又作抻/胂字},鶉{鵪鶉，古讀常倫切},鰆,逡,親{親切；助詞，動詞、形容詞後表結果},蝽,膥{俗字，卵，本地不用，而是用蛋，廣東粵客多用，廣西罕用，僅限部分地區，一說避諱亂，改用伸/抻/春},胂{伸也，～手，～懶腰，～直，又作伸/抻字},瞋,皴{皴裂},瑃,椿{椿樹},春,捵{同抻字},抻{拉、扯；伸也，～手，～懶腰，～直，又作伸/胂字},堾{石壘擋土牆；地名用字},嗔{生氣}
can2	tʃʰɐn35	哂{哂笑},鬒,辴,軫,診{急診，診療},袗,蠢{愚蠢，蠢材},胗{嘴脣潰瘍},縝,稹,矧,疹{麻疹，溼疹},疢{(又)},畛,槙{木密},槇{木密},昣
can3	tʃʰɐn33	櫬,齔,趁,親{親家},襯,疢
can4	tʃʰɐn21	嗪,陳,螓,蓁{蓁椒},臣,紃,秦,溱{溱潼},旬,揗{撫摩；順從},循,巡,塵
cang1	tʃʰɐŋ55	噌{叱責；噌吰}
cang3	tʃʰɐŋ33	蹭{磨蹭；蹭蹬}
cang4	tʃʰɐŋ21	䁬,鄫,曾{曾經},嶒,層{樓層，層次},䉕
cap1	tʃʰɐp5	㮑{(語)脆～～，非常脆},𠝞{(語)剪物聲},輯{編輯},蕺,葺,緝{緝拿，緝鞋口},楫{舟楫，讀同咠},戢,咠
cat1	tʃʰɐt5	䢺{(又)},齣{(又)},黜{(又)},詘{(又)},猝{(又)},漆,桼,柒{七的大寫},怵{(又)},出{(又)},七{第七，七夕；～曹[tʃʰu21]曹[tʃʰu35]（借字，本字或爲巧）、～巧[kʰiu35]來、～巧，猜碼口令，數字七}
cau1	tʃʰɐu55	抽,鶖,鰍,鞧,鞦{鞦韆，牛鞦},萩,篘,秋{秋天},瘳,湫{水潭},楸,搊{搊起來},掫{拿取東西}
cau2	tʃʰɐu35	丑{子丑},醜{醜惡},矁,瞅,杻{古刑具，似手銬},偢{同瞅字},侴
cau3	tʃʰɐu33	嗅{嗅覺；用鼻聞},齅{同嗅字},輳,蔟{太蔟},臭{臭味},腠,糗{乾糧},溴,湊{拼湊},殠
cau4	tʃʰɐu21	仇{仇敵；〈又〉姓，俗讀},酬,酋,遒,躊,讐,讎{校讎，讎定},蝤{蝤蠐},綢,籌,稠,疇,犨,泅{泅水，泅渡},椆{椆木，椆水},愁,惆,幬{床帳；車帷},囚,儔
ce1	tʃʰɛ55	俥{船上動力器；掌船動力器者，大俥},車{車輛},硨,唓{唓嗻；語氣詞，表輕蔑；～咧[lɛ55]，話多、愛表現，本字啁嘐（嘐啁）}
ce2	tʃʰɛ35	且,跙{𨇦跙，足利；〈語〉走、離開，俗字扯},撦,扯,尺{工尺}
ce3	tʃʰɛ33	笡{斜、陡},趄{傾斜；趔趄}
ce4	tʃʰɛ21	㙦,邪{驅邪，邪惡},輋{地名用字},斜{斜坡，傾斜}
cek3	tʃʰɛk3	刺{(白)刺骨，頭刺（頭痛），肉刺（心痛）},尺{尺寸},呎
cem1	tʃʰɛm55	鵮{鳥啄物；〈語〉鵝鴨等扁嘴類動物取食}
cem2	tʃʰɛm35	篸{(白)},鑔{(語)～～，小鈸，本字鍖},鍖{(白)～～，小鈸}
cem4	tʃʰɛm21	劖{(白)刺入，與插對轉，又作鑱/攙字},鑱{(白)長鑱；刺入，與插對轉，又作攙/劖字},攙{(白)刺入，與插對轉，又作鑱/劖字}
cen2	tʃʰɛn35	剷{(白)剷走，剷除},鏟{(白)鑊鏟；鏟走}
ceng1	tʃʰɛŋ55	清{(白)水清},青{(白)青色，面青青，青菜，多用於青白色}
ceng2	tʃʰɛŋ35	請{(白)請假}
cep1	tʃʰɛp5	𠝞{(語)剪物聲}
cep3	tʃʰɛp3	插{(白)}
cet1	tʃʰɛt5	㔍{(語)切物聲，引申指切開},設{(語)詞綴，短/薄～～，短/薄貌}
cet6	tʃʰɛt2	㔍{(語)又音}
ceu1	tʃʰɛu55	抄{(白)抄書},𤙴{(白)牴}
ceu2	tʃʰɛu35	吵{(白)吵耳},炒{(白)}
ceu3	tʃʰɛu33	抄{(白)翻找、亂翻}
ci1	tʃʰi55	呲{斥責},齹{齒參差},齝,黐{黏、粘},鴟,魑,髊,骴,飺,雌,郗{姓},趀,誺{不知},蠀{蠀螬},螭,蚩,胵{膍胵},縒{參縒，同參差},絺,笞,眵{眼眵},眥{睚眥，讀同疵},癡{癡情，白癡},痴{同癡字},疵{吹毛求疵},瓻,玼{玉的疵點},摛,差{參差，俗讀差別之差},媸,嘁{嘁嘁喳喳},嗤{嗤笑},哧
ci2	tʃʰi35	佌,齒,鮆{魚名},鉹,跐{踏；跐豸},豕{豬也},誃{離別},褫,胣,矢{飛矢，矢志},玼{鮮明},泚,此,恥,恀,姼{(又)},始{開始，始終},哆{張口},侈{奢侈}
ci3	tʃʰi33	伺{伺候，伺機},饎,跮{跮踱},赤{(語)打～肋，赤膊，打～腳，赤腳，語流音變},賜,覗,蛓,蚝{同蛓字},莿,胵{粵字，芙胵，家禽內臟，又作扶翅/腑胵},翨,翅,絘,笥,眙{直視},痓,熾,次,朿,廁{廁所},庛,幟{旗幟},嗣{(常)俗讀，讀同伺},啻,厠{同廁字，厠所},刺{魚刺，刺刀，行刺},儩,佽,佁{佁儗}
ci4	tʃʰi21	匙{匙羹，湯匙},鷀,鶿,馳,餈{餈粑},飼{(常)俗讀，讀同詞},遲,辭,踶{踶躕},踟,趍{趍趙},貾,謘,詞,蚳,薋,荎,茲{龜茲},茬{草盛貌；姓},茨,茌,茈{鳧茈},臍{肚臍，臍帶，古讀同齊},糍{同餈字，糍粑},篪,祠,磁{磁石},瓷{瓷器},濨,澬{古水名},泜{水名，在河北},池,歭{歭躇，同踟躕},柌,持,慈,弛,墀,坻{水中高地}
ci5	tʃʰi24	似,鈶,洍,汜,恃{仗恃，有恃無恐},峙{(又)對峙},姒
ci6	tʃʰi22	嗣{子嗣，嗣位},飼{飼料，飼養},飤{同飼字},食{簞食壺漿},寺{寺廟}
cik1	tʃʰek5	㡿,鶒,飭,鏚{鏚斧},赤{赤色，赤子，赤口日},螫{(又)},蓛{(又)},槭{槭樹},斥,敕,抶,戚{親戚；姓},慽,慼{悲慼},彳,嘁{(又)},哧{(又)},叱{叱吒，呵叱}
cim1	tʃʰim55	䙲{同遷字},錟{同銛字，鋒利},鋟,銛,鉆{鑷子},釺{(習)禾～，兩頭尖的扁擔，挑稻草、茅草用},遷{(習)遷移，遷徙},襜,薟{豨薟},纖{纖細},籤{抽籤},籛{馬具；姓},簽{簽字},箋{(習)便箋，信箋，讀同籤},牋{同箋字},殲{殲滅},櫼,憸,孅,僉,䙴{同遷字}
cim2	tʃʰim35	諂
cim3	tʃʰim33	僭,韂,槧,暹,塹
cim4	tʃʰim21	撍{拔、抽，又作撏字},灊,潛,撏{拔、抽，又作撍字}
cin1	tʃʰin55	䙲{(又)},韆{鞦韆},阡{阡陌},釺{(書)},遷{(書)},躚{蹁躚},芊{芊綿，芊芊},籛{(又)},箋{(書)},牋{(又)},梴{木長貌},杄,扦{扦子，扦插},圲,千{萬千，千金},仟{千人之長；千的大寫},䙴{(又)}
cin2	tʃʰin35	嘽{寬舒},闡{闡述，闡明},蕆,燀{炊},淺,囅
cin3	tʃʰin33	倩{(又)},茜{(又)茜草}
cin4	tʃʰin21	前,錢,辿,躔,纏{纏繞；糾纏},瀍,廛,媊{(又)}
cing1	tʃʰeŋ55	偁{同稱字},鯖{魚名},青{青年，青春，青草，多用於年齡或青綠色},赬,蟶{蟶子},蜻{蜻蜓},虰{虰螘},腈{(又)有機化合物的一類},粁,稱{稱呼；相稱},清{清理},氰{(又)},檉,圊,僜{醉行貌}
cing2	tʃʰeŋ35	庱,騁,請{請客，請假}
cing3	tʃʰeŋ33	掅{揪住},稱{稱心；〈又〉相稱},秤{桿秤},碃
cing4	tʃʰeŋ21	䝼{受賜},餳{飴，糖稀},酲,郢{(又)},逞{逞強，得逞，讀同呈},裎,程,珵,澄{澄清},澂{澄的本字},氰{碳氮化合物},晴,成{成數，幾成},懲,憕,情,埕{罈子},呈
cip3	tʃʰip3	唼{唼佞},妾
cit3	tʃʰit3	㬚,設{建設，設計},竊,澈,沏{水聲},撤,掣{(又)},懘{(又)},徹,屮,切{切開}
ciu1	tʃʰiu55	幧,鍬{鐵鍬；〈語〉打嗐[hɐt5]～，打噴嚏},釗,超,繰{繰邊},炤{同昭字},昭{昭然，昭雪；王昭君，展昭},悄{靜悄悄},怊,弨
ciu2	tʃʰiu35	愀
ciu3	tʃʰiu33	俏,鞘{刀鞘},誚,肖{生肖，肖像},帩,峭,偢{傻偢}
ciu4	tʃʰiu21	䩌,譙,瞧,潮,樵,朝{朝代，朝向；朝鮮，古讀陟遙切},晁,憔,劁{劁刈，劁豬}
co1	tʃʰɔ55	初,蹉{蹉跎},磋{切磋，磋商},瑳,搓{搓手，揉搓},嵯
co2	tʃʰɔ35	憷,齼,脞,礎{基礎},濋,楚
co3	tʃʰɔ33	剉,錯{錯誤；交錯，古讀入聲，倉各切},銼,莝{莝草},措{措施},挫,厝
co4	tʃʰɔ21	痤,𩄝{雨聲},齹{齒根},鹺,鋤,鉏{同鋤字},酇{古縣名；白酒},蒫,矬{矮},瘥{病疫}
co5	tʃʰɔ24	坐{坐車，坐標，坐臥，保留濁上}
co6	tʃʰɔ22	昨{(語)又音，語流音變}
coek3	tʃʰœk3	㪕{㪕起棍子},鵲{喜鵲},雀{麻雀；打麻～，打麻將},逴,踔,蔟{叉取},綽{寬綽，綽號},碏,焯{略煮一下，～菜},淖{同綽字},棤{(又)},婼{不順從},婥
coeng1	tʃʰœŋ55	倀{爲虎作倀},鶬{鶬鶬；金飾貌},鯧{鯧魚},閶,鏘,鎗{同槍字},錆,蹌{動也；蹌蹌，舞貌},菖{菖蒲},箐{竹名},窗{窗戶，門窗，舊讀},瑲,猖,槍,椙,昌,搶{以頭搶地},戧{逆},將{請也，將子無怒},娼,嗆{吃飯嗆着},倡{提倡，倡議；倡優}
coeng2	tʃʰœŋ35	搶{搶奪}
coeng3	tʃʰœŋ33	倡{(又)提倡，倡議},鬯,韔,蹌{踉蹌},瑒{祭祀之圭},熗{一種烹飪方法，熗菜，熗鍋},暢{通暢，暢快；〈語〉破開，～散紙，將大額鈔票破開},戧{撑},悵,嗆{油煙嗆人},唱{唱歌，歌唱；〈語〉到處說，～衰，貶損，～票，喊票}
coeng4	tʃʰœŋ21	償,鱨,長{長短；身無長物},詳,薔,萇,腸{腸胃，大腸},翔,祥,牆,檣,戕,徜,廧,庠,常{經常，常識；姓},嬙,嫦,墻,場,嚐{品嚐},嘗{嘗試}
coi1	tʃʰɔi55	啋
coi2	tʃʰɔi35	䐆,采{文采，神采},茝{香草名},綵{剪綵，綵球},睬,採{採摘，採取},彩{光彩，彩色},寀
coi3	tʃʰɔi33	埰{埰地},蔡,菜,縩,棌{棌樹}
coi4	tʃʰɔi21	才{才華},財,豺{(常)豺狼},裁,纔{剛纔},材
cok3	tʃʰɔk3	剒,逪,縒{縒綜，同錯綜},擉{剌也；～人，用肘部擊人},戳{戳穿；郵戳}
cong1	tʃʰɔŋ55	䱽{同鯧字},鶬{鶬鶊},鯧{(常)鯧魚，俗作䱽/倉字},蒼,艙,窗{(又)},瘡,滄,傖,倉
cong2	tʃʰɔŋ35	厂{同廠字},駔{駔子},闖{闖入，闖禍},鋹,氅,昶,敞,惝,廠
cong3	tʃʰɔŋ33	刱,闖{撞，～爛，～倒，～見},愴,創{創造；創傷，古讀平聲}
cong4	tʃʰɔŋ21	噇,藏{隱藏},牀{牀鋪，河牀},橦{竿},床{同牀字},幢{人影幢幢，經幢}
cot6	tʃʰɔt2	腏{(語)男陰，戳物的合音，俗字戳/𨳍},𨳍{男陰，戳物的合音，又作腏字}
cu1	tʃʰu55	操{操作；操守，古讀去聲},觕{同粗字},粗
cu2	tʃʰu35	艸{同草字},騲{騲雞},草
cu3	tʃʰu33	噪{噪聲},𥖨,醋,酢{酢漿草；同醋字},躁,譟{譟動，鼓譟},藻{(常)水藻，小球藻，讀同燥/躁},糙{粗糙，糙米},燥,慥
cu4	tʃʰu21	嘈{嘈雜，嘮嘈（同㗦嘈）},𥕢,螬,艚,漕,殂,槽{馬槽，跳槽},曹,徂,巢{(又)}
cui1	tʃʰui55	催,衰{減也；同縗字，齊衰},縗,璀,炊,榱,摧,崔{姓},嗺,吹{吹噓；鼓吹，古讀去聲}
cui2	tʃʰui35	揣{揣度，揣摩},漼
cui3	tʃʰui33	啐,萃,膵{膵臟，膵液},膬,脺{易斷也},脆,翠,粹{純粹},瘁,焠,淬,毳,悴,啜{姓}
cui4	tʃʰui21	捶,𢶀{損},𡃴,隨,隋,鎚,錘{鐵錘，秤錘},沝{(又)},槌{棒槌，鼓槌；拳～，拳頭},椎{同槌/捶字},棰
cuk1	tʃʰʊk5	亍,齪{齷齪},餗,閦,速,蹴,蹙,踧{踧踖},諔,觸,觫,触,蔟{蠶蔟},蔌,蓄{儲蓄},簌,簇,築{建築},筑{古代弦樂器},矗,畜{畜生；畜牧},琡,滀,涑,束,斶,搐,俶{始也；整也},促
cung1	tʃʰʊŋ55	㳘,驄,鏦,衝{衝鋒},蔥,蓯,葱,茺,艟{(又)},舂{舂米},聰,翀,璁,珫,熜{微火；熱氣},涌{小河，一說本字潨；地名用字},沖{沖洗},樅{冷杉},摏,憧{憧憬},悤,怱,忡,囱{同囪字},囪{煙囪},匆,充
cung2	tʃʰʊŋ35	埫,慫{(又)},寵
cung3	tʃʰʊŋ33	㧤,銃{火銃},蹱{(白)唦[ʃa21]哩[li55]躘[lʊŋ22]～，莽撞；躘[lʊŋ33]躘[lʊŋ33]～～，踉踉蹌蹌},揰{推擊}
cung4	tʃʰʊŋ21	㗰,重{重複，重新},賨,蟲,虫{同蟲字},藂,种{姓},琮,潨{水流匯合處},潀{水流匯合處},淙{(書)},松{松樹，松木，松子},悰,從{跟從；從容，古讀七恭切、書容切},崇,叢,从
cung5	tʃʰʊŋ24	重{輕重，重要，重病，保留濁上}
cy1	tsʰɿ55	呲{(老派)},齹{(老派)},髊{(老派)},骴{(老派)},飺{(老派)},雌{(老派)},趀{(老派)},蠀{(老派)},縒{(老派)},眥{(老派)},疵{(老派)},玼{(老派)},差{(老派)參差}
cy2	tsʰɿ35	佌{(老派)},鮆{(老派)},跐{(老派)},玼{(老派)},泚{(老派)},此{(老派)}
cy3	tsʰɿ33	伺{(老派)},賜{(老派)},覗{(老派)},蛓{(老派)},蚝{(老派)},莿{(老派)},絘{(老派)},笥{(老派)},次{(老派)},朿{(老派)},廁{(老派)},庛{(老派)},嗣{(老派)俗讀，讀同伺},厠{(老派)},刺{(老派)},儩{(老派)},佽{(老派)}
cy4	tsʰɿ21	慈{(老派)},鷀{(老派)},鶿{(老派)},餈{(老派)},飼{(老派)俗讀，讀同詞},辭{(老派)},詞{(老派)},薋{(老派)},茲{(老派)},茬{(老派)},茨{(老派)},茌{(老派)},茈{(老派)},糍{(老派)},祠{(老派)},磁{(老派)},瓷{(老派)},濨{(老派)},澬{(老派)},柌{(老派)}
cy5	tsʰɿ24	似{(老派)},鈶{(老派)},洍{(老派)},汜{(老派)},恃{(老派)},姒{(老派)}
cy6	tsʰɿ22	嗣{(老派)},飼{(老派)},飤{(老派)},食{(老派)},寺{(老派)}
cyu1	tʃʰy55	坥,趨,趍{同趨字},貙,蛆{生蛆},芻
cyu2	tʃʰy35	取,娶
cyu3	tʃʰy33	處{處所，到處},趣,覷
cyu4	tʃʰy21	儲{儲蓄},鶵,雛{雛形，鳳雛},除,鉏{古國名；姓},躕,躇,滁,涂{水名，滁河},櫥,徐,廚
cyu5	tʃʰy24	佇,貯,詝,褚{姓},處{相處，處理，讀同杵},苧{苧麻},芧{同苧字},紵,竚,砫,楮,柱,杼,杵{舂杵，杵臼},拄{(又)讀同柱},宁{門屏之間}
cyun1	tʃʰyn55	堾{(老派)},鶉{(老派)},鰆{(老派)},鑹,邨,逡{(老派)},躥{(又)跳},蝽{(老派)},膥{(老派)},穿,皴{(老派)},瑃{(老派)},汆{汆丸子，汆湯},氚,椿{(老派)},村,春{(老派)},川
cyun2	tʃʰyn35	喘,踹{足跟},踳{同舛字},蠢{(老派)},舛,忖,堾{同踳字}
cyun3	tʃʰyn33	串,釧,躥{跳；囂張},篡,竄{流竄，竄逃},爨,攛,寸,吋
cyun4	tʃʰyn21	佺,鰁,銓,醛,遄,輇,蹲{蹲蹲；蹲了腿},跧,詮,荃,篅{盛穀具},筌,痊,瑔,泉,欑,椽{椽子},攢{攢聚},存,圌{同篅字},全,傳{傳達，傳奇}
cyut1	tʃʰyt5	䢺,齣{一齣戲},黢{黢黑，黑黢黢},黜{罷黜，黜退},詘{同黜字},猝{倉猝，猝死},焌{使火熄滅；一種烹調法},怵,出{出去，外出}
cyut3	tʃʰyt3	撮{一撮，撮合}
daa1	ta55	咑{叱驢馬聲},打{(外)量詞，十二個，英語dozen}
daa2	ta35	打{擊打，打球；〈語〉處所介詞，相當於喺，老派用法，～啲，在這兒}
daa3	ta33	咑{(語)啲～，嗩吶或嗩吶聲}
daai1	tai55	呆{書呆子，癡呆，本字懛；〈又〉呆板},獃{書獃子，癡獃，本字懛；〈又〉獃板},懛{懛獃}
daai2	tai35	傣{傣族},歹,大{(白)老～，老人家}
daai3	tai33	帶{帶領，鞋帶},襶{(書)},戴{戴帽，愛戴；姓}
daai6	tai22	大{大小；大夫，大黃},軑,汏{洗}
daak1	tak5	咑{嘞[lak5]～，不整潔}
daam1	tam55	儋,鵮{(文)},頕,躭,覘{擡頭},聃,耽,眈{虎視眈眈},擔{(動)擔任}
daam2	tam35	疸{(訓)黃疸又作黃膽，訓讀膽},膽,紞{冕前垂者}
daam3	tam33	帎{冠俯前},擔{(名)擔子；～潤/竿，扁擔，～箕，簸箕}
daam6	tam22	倓{通賧字；倓定，又作淡定/澹定},髧{髮垂},賧,萏,窞{深坎},澹{澹泊，澹然，恬澹},淡{(文)淡泊，淡漠；淡定，又作倓定/澹定},氮,欿{坎欿},憺,惔{通憺字},埮{地平而長},噉{同啖字},啖{吃；姓；〈量〉口}
daan1	tan55	丹,鄲,襌,簞,癉{火癉},殫,單{單獨，孤單；～丁，孤單、單獨}
daan2	tan35	撢{同撣字},疸{黃疸},泹{(白)～水，用開水焯},撣{雞毛撣子}
daan3	tan33	旦{元旦，花旦},鉭{(又)},誕,癉{勞病；憎恨}
daan6	tan22	亶{同但字},蜑{蜑家，俗字疍},蛋,膻{膻中},疍{疍家，本字蜑},燀{熱甚；過度},灒{(語)濺},濽{(語)濺},濺{(訓)訓讀灒/濽},澶{澶漫},泹,憚,彈{子彈，彈弓},僤,但
daang1	taŋ55	噹{(語)象聲詞，金屬撞擊聲}
daap1	tap5	嗒{嘀嗒；咂嘴聲，食得～～聲，與啖對轉}
daap3	tap3	䐛,鎝{翻土農具},褡,耷{大耳},答,瘩,疸{疙疸，即疙瘩},溚{溼，溼溚溚},撘{同搭字},搭
daap6	tap2	䂿{舂已復擣之},龘,龖,闒{樓上戶},遝,蹋,踏,沓{一沓紙，紛至沓來，與粒旁轉},嚃{(又)}
daat1	tat5	噠{(語)～～響，啪啪響}
daat3	tat3	墶{〈名〉圪墶；〈量〉塊，～定[tɛŋ22]，地方，又作笪字},𢴈{摔，本字躂},靼,躂{(語)摔倒；用力摔；躺倒；俗字𢴈},笪{〈名〉竹笪，洞～，茓子；〈量〉塊，～定[tɛŋ22]，地方，又作墶字},炟,怛,妲
daat6	tat2	䃮,鐽,達{到達},薘,繨,燵,噠{象聲詞}
dai1	tɐi55	䐎,鞮,羝,磾,氐{氐羌；氐宿},彽,底{(白)外～，外面，下～，下面，本字低},低{高低，外低（外面），下低（下面）}
dai2	tɐi35	厎{(又)},骶,阺,邸,詆,砥,牴{牴觸，牴牾},氐{古同柢},柢{根柢},抵{抵押，抵抗；～值，划算、值得，～諗（恁），能忍受、吃得虧},底{底部，水底},坻{寶坻縣}
dai3	tɐi33	媂,𤧛,諦,螮,蒂,締,禘,碲,渧,帝
dai6	tɐi22	俤,隸{奴隸，隸書，讀同棣},隷{同隸字},遞{傳遞，遞交},逮{逮捕；逮老鼠},踶{踢},第,棣,杕,悌{孝悌，愷悌},弟{兄弟，徒弟},嵽{岹嵽},娣{(又)},埭
dak1	tɐk5	嘚{馬嘟～，馬踏聲},鍀,惪,德,得
dak6	tɐk2	樴{(又)},螣{食禾蟲},特
dam1	tɐm55	䏙{肚～，肚子；肥～～，矮胖貌；酸～～，很酸；與𦛚旁轉},揼{以頭撞，假借字，疑本字揕}
dam2	tɐm35	丼{投物井中聲；姓},黕{污垢，黑；矮～～，矮矬矬},沊,抌{捶，與䂿/撘對轉；搶劫，捱土匪～}
dam3	tɐm33	揼{換，假借字，疑本字擔},髧{(語)垂下，與耷對轉}
dam6	tɐm22	䂿{(白)跺，～腳},𨂽{跺，本字䂿}
dan1	tɐn55	吨{同噸字},驐,鐓{同驐字；衝壓金屬板，使其變形},蹾{蹲下；猛地往下放},蹲{蹲下，蹲點},礅,敦{敦厚},撴,撉{擊也},扽{猛地拽、扯、放，～斷，與挃/𠱂對轉},惇,墩{墩布，土墩},噸
dan2	tɐn35	囤{(白)米囤},躉{躉船，躉賣},墩{(白)橋～，橋墩，石～，柱下石，草～，蒲團，坐～，坐凳；放置（重物）}
dan3	tɐn33	扽{顛簸；震動，～落}
dan6	tɐn22	坉{同沌字；塞},頓{整頓，頓號},鈍{遲鈍，鈍角},遯,遁,砘,盾{矛盾},盹,燉,炖,沌{混沌},楯{同盾字},屯{地名，屯里}
dang1	tɐŋ55	僜{同登字},鐙{古代盛熟食的器皿；同燈字},蹬{腳向下用力},簦,瞪{瞪眼},登,璒,燈,噔
dang2	tɐŋ35	戥{小秤，釐～，戥子},等{相等，等候；用容器去接，～水，接水}
dang3	tɐŋ33	凳,鐙{鞍鐙，馬鐙},磴,嶝
dang6	tɐŋ22	僜{倰僜},鄧,蹬{蹭蹬},蜑{(又)蜑家，後字逆同化，俗作鄧家},疍{(又)疍家，後字逆同化，俗作鄧家},澄{水渾，澄一澄},戥{使平衡、使相稱，一說本字幐/𢯭}
dap1	tɐp5	耷{(語)垂下，～頭，低頭，與髧對轉}
dap6	tɐp2	䂿{(白)砸、捶，～背脊，俗字撘},𢱕{砸、捶，本字䂿},沓{(白)厚～～，很厚},撘{(語)砸、捶，～背脊，本字䂿}
dat1	tɐt5	咄{咄咄逼人；〈語〉頂撞，本字窒},𠱂{用力往下放，與扽對轉，本字挃},飿{餶飿},腯{肥也；肥～～，胖貌，與肭旁轉},窒{(白)頂撞，俗字咄},挃{(白)用力往下放，與扽對轉，俗字𠱂}
dat6	tɐt2	凸,𠸂,鶟,葖,腯{矮～～，矮貌},突{突出，突然；象聲詞，機槍聲；啞～～，啞口無言}
dau1	tɐu55	㨮,蔸{禾蔸；量詞，棵、叢、條，一說本字兜，與株同源，上古侯部},篼,唗,兜
dau2	tɐu35	抖,陡,鈄,赳{(習)赳赳，俗從斗作﨣},蚪,糾{(習)糾纏，糾正，俗從斗作紏},斗{北斗}
dau3	tɐu33	竇{(白)窩、巢，簕（竻）～，難打交道},鬭{拼合，～木，木工活，～木佬，木匠，又作鬥字},鬥{爭鬥；～毒，故意作對；～木，拼合木頭（指木工活），又作鬭字},逗{挑逗，又作挑鬥；引逗，～鬼崽，逗小孩}
dau6	tɐu22	哣{俗字，吽～，迷糊、不清醒，本地又引申爲古板、難溝通，疑本字䠗逗/譳䛠},𢭃{四捧爲一𢭃},餖,酘{(語)以藥毒殺，～老鼠，俗字毒},逗{逗號，逗遛},豆{黃豆；～泥，質量差},讀{句讀},荳,脰,竇{情竇；姓；〈語〉老～，父親},痘,毒{(白)又音，以藥毒殺，～老鼠，或爲上古覺部加-s尾形成的同族詞，另一說本字酘}
de1	tɛ55	哆{(語)嗬[hɔ21]～，嗩吶},爹{爹孃，爹爹}
de2	tɛ35	嗲{撒嬌},襶{(習)褦襶（衣着不整；吊兒郎當）}
de4	tɛ21	嗲{詞綴，流～～，滴瀝貌；口水流啲～，口水滴瀝貌}
dek3	tɛk3	趯{(訓)跑，本字迪},迪{(白)跑，俗字趯}
dem1	tɛm55	鵮{(白)叮、啄；叼、銜}
dem2	tɛm35	點{(白)蘸，～鹽，～水}
deng1	tɛŋ55	丁{(白)人丁，豆丁（小個子）},釘{(白)鐵釘；釘住},盯{(白)},疔{(白)},叮{(白)（蚊子）叮，元音象義}
deng2	tɛŋ35	頂{(白)名詞，屋頂}
deng3	tɛŋ33	掟{(語)擲、扔，本字矴/碇，與扚對轉},碇{(白)蒂，俗字椗；擲、扔，俗字掟，與扚對轉},矴{(白)蒂，俗字椗；擲、扔，俗字掟，與扚對轉},椗{(白)蒂，本字矴}
deng6	tɛŋ22	埞{地方，本字定，另一說地方的合音},訂{(白)訂檯，訂票},定{(白)鎮靜；地方，～方，地方，陰～，背陰處，俗字埞，另一說地方的合音}
dep1	tɛp5	䑜{(語)小口嚐；～嘴，親嘴；本字嗒},鰈{(語)魚～子，瘊子，源自魚鱗痣},嗒{(白)～嘴脣，咂嘴；～嘴，親嘴；俗字䑜}
det6	tɛt2	噠{(語)手錶聲，元音象義},𠸂{(白)},腯{(又)矮～～，矮貌}
deu1	tɛu55	屌{男陰，麻～，本字鳥},鳥{(白)男陰，麻～，俗字屌}
deu4	tɛu21	嫋{(白)又音，軟～～，端組-泥明旁轉}
deu6	tɛu22	掉{(白)丟棄，已罕用}
di1	ti55	啲{一～，一點兒，本字稚，知組讀如端組；阿～嚕～，這裏那裏；～咑，嗩吶或嗩吶聲},姼{(語)公～婆～，老頭子老太太，市區已極罕用}
di2	ti35	弟{(語)弟[ti21]～，小男孩的暱稱}
di6	ti22	哋{我～，我們，一說本字等（上古蒸部），與臺（上古之部）字對轉，輩也},墬,地{土地，鋤大地；助詞}
dik1	tek5	嘀{嘀嗒},鏑,蹢{蹄},菂,的{目的，的確},玓,滴{滴水，水滴；～息，小巧，與丁對轉},樀,扚,嫡
dik6	tek2	嘀{嘀咕},頔,鏑{(又)},逖{(又)},迪{啓迪，迪吉},踧{踧踧},覿,荻,翟{長尾野雞},糴,篴,笛,狄,滌,浟{貪利貌},敵,嫡{(又)}
dim1	tim55	掂{掂量，本字敁},踮,敁{敁敠}
dim2	tim35	典{(習)經典，典型},點{點燈，點炮，小數點；〈語〉怎麼，底物的合音},靦{靦顏},覥,腆{(習)靦腆，腆肚},碘{(習)碘酒},淟,晪,捵{推、頂}
dim3	tim33	坫,阽,玷,惦,店
dim6	tim22	墊{(訓)坐墊，墊錢，訓讀簟},𠶧,簟{蓆},磹{石楔；同簟字},掂{(語)妥當，搞～，一說本字扂},扂
din1	tin55	巔,顛,癲,滇{滇池；雲南},槙{樹梢},槇{樹梢}
din2	tin35	典{(書)},碘{(書)}
din6	tin22	佃{佃戶},靛,電,鈿{金花形飾物},癜,甸,琔,澱{澱粉，沉澱},淀{白洋淀},殿,奠
ding1	teŋ55	丁{丙丁，壯丁，肉丁；單～，孤單、單獨，與滴對轉},靪,釘{(文)},酊{碘酊},訂{(訓)訂書機，訓讀釘},虰{虰蛵},耵,盯{盯住，盯梢},疔{疔瘡},町{地名，畹町（在雲南），西門町（在臺灣）},玎,叮{叮嚀；叮咬},仃{伶仃；奀/瘦～～，瘦貌}
ding2	teŋ35	酊{酩酊},鼎,頂{(文)動詞，頂住}
ding3	teŋ33	椗{(文)同矴/碇字},飣,碇{同矴字，錘舟石},矴{錘舟石，又作碇字}
ding6	teŋ22	啶,錠{銀錠},鋌{銅鐵礦石；同錠字},訂{(文)訂婚，修訂},萣,腚,聢,掟{天掟},定{安定，定時}
dip3	tip3	跕{墜落}
dip6	tip2	喋{喋喋不休，喋血},鰈{鰈魚},迭{(又)俗讀},蹀{躞蹀，蹀足},諜,蝶,秩{(又)俗讀},碟,疊,牒,渫{渫渫},楪{同牒/碟字},揲{摺揲},堞
dit1	tit5	啲{(又)表少量，或爲連讀音變，另一說本字尐},尐{(又)少}
dit3	tit3	跌
dit6	tit2	䏲,𢲼{擿也},迭{更迭，迭代},跮{跮跮},詄,耋,絰,紩,秩{秩序},瓞,昳{太陽偏西},帙,嵽{嵽嵲},垤,咥{咬}
diu1	tiu55	䯾{小兒留髮},鵰{射鵰，一箭雙鵰},鯛,雕{射雕；雕像，雕刻},錭,銩,貂,碉,琱{琱琢},汈,椆{椆苕},彫{彫刻；彫弓},叼,刁,凋{凋零，凋謝},丟
diu2	tiu35	屌{性交，本字鳥，語氣強烈時會變高降調},鳥{(白)性交，俗字屌}
diu3	tiu33	吊{上吊},銱,釣,窵,弔{弔唁}
diu6	tiu22	嬥{嬥嬈},銚{燒器},調{音調，調動},藋{灰藋菜},莜{草田器},掉{改掉，走掉}
do1	tɔ55	哆{哆嗦},多
do2	tɔ35	凩{(又)},躲,跺,綞{綞子},朵{花朵，耳朵，一朵},埵,嚲,哚
do3	tɔ33	剁{剁肉，剁碎},垛{柴垛}
do4	tɔ21	𣳼
do6	tɔ22	墮,馱{馱子；地名，馱盧},陊,舵{(又)},惰
doe1	tœ55	哆{(語)又音，嗬[hœ21]～，嗩吶},噘{(語)～嘴，噘嘴，又作嘟/𨹄字；（蚊蟲）叮，（馬蜂）蟄}
doe2	tœ35	哚{(白)},遞{(語)遞},朵{(白)一朵}
doe4	tœ21	𣳼{(又)}
doek1	tœk5	剁{(訓)又音},斲{(又)}
doek3	tœk3	剁{(訓)～肉，訓讀斲},斲{剁，～肉},啄{啄木鳥，啄食}
doeng1	tœŋ55	叮{(白)（雞）叮，元音象義，又作啄字},啄{(語)叮，一說啄的陽入對轉，另一說叮[tɛŋ55]的音變；烏～～，糊塗}
doet1	tœt5	咄{(語)吻}
doi6	tɔi22	代{代表，交代（口語用交帶）},黛,駘{駘蕩},靆,迨,貸{(又)},詒{欺詐},袋,紿,甙,玳,殆,怠{怠慢，怠工},待{等待，擔待（口語用擔戴）},岱,埭{(又)},垈
dok1	tɔk5	突{(語)～頭，奔兒頭}
dok6	tɔk2	度{量度},鐸,踱
dong1	tɔŋ55	噹{啷噹},鐺{鋃鐺},襠{褲襠，開襠褲},簹,當{應當，當時},璫
dong2	tɔŋ35	党{党項},黨,讜,欓,檔{檔案，檔次，高檔},攩,擋{阻擋},壋
dong3	tɔŋ33	壋{(又)},譡{諰[ɬai55]～，奚落諷刺人},當{典當，當作，適當},檔{攤檔，拍檔},擋{摒擋}
dong4	tɔŋ21	噹{(語)象聲詞，～～響，鑼聲響}
dong6	tɔŋ22	宕{跌宕，延宕},趤,蕩{遊蕩，放蕩},菪,碭,盪{盪漾，盪滌},璗
du1	tu55	刀,魛,闍{城門臺},都{都城；都是；姓},舠,氘,忉,嘟{咕嘟，嘟囔；花咕～，花蕾、花骨朵},叨{嘮叨}
du2	tu35	倒{倒塌，顛倒，倒立，倒水},賭,禱,睹,擣,搗,島,堵
du3	tu33	倒{倒掛，倒退；～反，反而；～矴[tɛŋ33]，倒置},道{(語)知道，本字知到，動補結構},捯,到{到底，達到；見到，知到}
du6	tu22	妒,𨧀,鍍,道{道路，大道；知道},蹈,蠹,芏,艔{渡船，本字渡},纛,稻,盜,燾{覆蓋},渡,毒{(白)以藥毒殺，～老鼠；坊間戲稱毒友爲道友},杜,悼,度{長度},幬{覆蓋},導,妬
dui1	tui55	䭔{煎～},堆,埻{欑塗所覆}
dui2	tui35	㨃{捅}
dui3	tui33	兌,祋,碓,敦{盛黍稷的器具},對,兑
dui6	tui22	䃍,隊,鐓{同錞字},錞{鐏},懟,憝
duk1	tʊk5	㞘{同䐁字},𧰵{戳、刺、捅，與捅對轉},𢽚{同𧰵字},𡰪{同䐁字},篤{篤厚，篤信},督{督促，監督},涿{(語)量詞，本字䐁},厾{輕擊、輕點；刺、捅，本字𧰵},䐁{容器或物體底部；量詞},㧻{同𧰵字}
duk6	tʊk2	櫝,黷,髑,頓{冒頓},讀{讀書},纛{(又)},碡{磟碡，又作碌碡},獨,犢{牛犢},牘,瀆,毒{毒蛇，病毒；鬥～，故意作對；古地名，身毒}
dung1	tʊŋ55	冬,鼕{鼓聲},鶇,鮗,蝀{(又)},菄,氡,柊,東,崬,咚
dung2	tʊŋ35	㨂{擊也},董,捅{(白)捅，與𧰵對轉，俗字㨂},懂
dung3	tʊŋ33	凍{冷凍},蝀,腖
dung4	tʊŋ21	咚{(語)象聲詞},鼕{(語)象聲詞}
dung6	tʊŋ22	侗{侗族},詷{說謊},胴,硐,洞{山洞，洞察},棟{棟樑；一棟},戙{船板木；〈語〉豎起},慟,恫{恫嚇},峒{山洞},垌{田垌；地名，平垌村，潭垌},動,働
dut1	tut5	𡁯{～～車，童語，汽車}
dyun1	tyn55	端,耑{端的古字；姓}
dyun2	tyn35	短,𢭃{同短字}
dyun3	tyn33	斷{判斷，決斷，斷估}
dyun6	tyn22	塅,鍛{鍛鍊，鍛造},緞,籪,碫,瑖,煅,段,椴
dyut1	tyt5	咄{(語)吻},𡁯{～嘴，親吻},腯{(又)肥～～，胖貌}
dyut3	tyt3	掇{(又)},敠{敁敠}
dyut6	tyt2	奪,敚,敓
e3	∅ɛ33	嘅{(語)弱讀},𡲢{(又)},擠{(語)擠靠、套近乎},屎{(語)又音}
e6	∅ɛ22	欸{嘆詞},誒{嘆詞},虵{(語)蚅～，蛤蚧，擬蛤蚧叫聲得名}
ek3	∅ɛk3	膱{(白)弱讀}
en2	∅ɛn35	偃{(白)踮},躽{(白)挺，躽胸凸肚}
et3	∅ɛt3	䊦{(白)糍粑},噎{(又)}
eu1	∅ɛu55	吆{(白)叫，喊}
eu2	∅ɛu35	拗{(白)～斷，折斷}
eu3	∅ɛu33	坳{(白)山坳},詏{(白)同拗字，～頸，頂嘴},拗{(白)～頸，頂嘴，又作詏字}
faa1	fa55	糀,花{開花}
faa3	fa33	化{化學，分化}
faa4	fa21	吪{(語)象聲詞，～～聲；詞綴，水流～～，車開～～}
faai3	fai33	噲,駃{快馬；通快字},筷{筷子，碗筷},快{快慢，愉快},塊{一塊}
faak3	fak3	礊{抽打}
faan1	fan55	噃{聲也},返{(白)～屋，回家，～工，上班，～膊，換肩},蕃{同番字},翻{翻譯，推翻，翻新},番{幾番，番茄},幡{經幡，幡然醒悟}
faan2	fan35	反{反覆；平反，古讀平聲},𠆩,返{返回，往返},橎
faan3	fan33	嬎{鳥下蛋},販,範{(常)模範，師範，前字調類化},畈,泛{廣泛，泛舟},汎,氾{氾濫},嬔{同嬎字，鳥下蛋}
faan4	fan21	凡,鷭,鐇,釩,蹯,袢{近身衣},蘩,藩{藩籬；藩衍},蕃{蕃衍，蕃茂},繁{繁華},礬,璠,燔,煩,氾{姓},樊,帆,墦
faan6	fan22	梵,飯,范{姓},範{示範，模範，師範},犯{犯人，犯法}
faat3	fat3	法{方法},髮{頭髮},醱{醱酵，同發酵},砝,發{發財},琺,灋{同法字}
faat6	fat2	乏,𠲎,閥,罰,筏,拂{(語)甩、摔；用鞭抽},垡,伐
fai1	fɐi55	噅{(文)},麾{(文)},隳{(文)},輝{(文)},褘{(文)},翬{(文)},琿{(文)璦琿},煇{(文)},暉{(文)},撝{(文)},揮{(文)}
fai3	fɐi33	䛍{言急；〈語〉癡/顛～，瘋癲貌，俗字廢},鐨,費{費用},芾{蔽芾},肺,砩{以石攔水},沸{沸騰，沸水},廢{廢品，作廢}
fai6	fɐi22	吠
fak1	fɐk5	礊{甩，與揈對轉}
fak6	fɐk2	𦑌{(語)跳～～，跳動貌}
fan1	fɐn55	㬟{同朆字},雰,閽{(文)},錀{兔奄錀},醺{(文)},酚,薰{(文)},葷{(文)},芬,翂,纁{(文)},紛,玢{賽璐玢},獯{(文)},燻{(文)},熏{(文)},氛,棼{棼棼},棻,朆{吳語字，弗曾},曛{(文)},昏{(文)},婚{(文)},吩,勳{(文)},勛{(文)},分{分開}
fan2	fɐn35	粉
fan3	fɐn33	瀵,馴{(常)俗讀，讀同訓},訓{教訓},糞,瞓{睡，本字睏，罕用}
fan4	fɐn21	墳,鼢,賁{大；三足龜},豶{牡豕},焚,濆{水邊},汾,棼{紛亂}
fan5	fɐn24	僨,鱝,憤,忿{忿恨},奮{奮鬥，興奮},坋
fan6	fɐn22	份{兩份，月份},忿{(又)冇～氣/頸，不服氣},奮{(又)興奮},分{本分}
fang3	fɐŋ33	揈{甩，與礊對轉}
fang4	fɐŋ21	揈{(又)}
fat1	fɐt5	㧾{擊也},𩖼,𧿳{跳；〈語〉摔，～跤，摔跤，本字拂},黻,魆,髴{髣髴},韍,鍃,茀,芾{草木茂盛},艴{淺色；艴然},胐{臀；屎～，屁股，俗字窟},紼,紱,笏,窟{窟窿，洞窟},祓,矻{(又)},狒{(語)狒狒，讀同弗},淴,沸{灑；泉涌貌},氟,欻{忽然},昒,搰{搰搰},拂{拂曉，拂塵；拭；甩；〈語〉摔，～跤，摔跤，俗字𧿳},惚,忽{忽然，忽略，疏忽},彿{彷彿},弗{弗如，弗要},巿,堀,囫,唿{唿哨},佛{仿佛},䬍{疾風貌},㩿{不穩}
fat6	fɐt2	佛{佛教},砩{砩石},狒{(語)又音},拂{(又)拂曉，拂塵},怫{怫鬱，怫然},弗{(又)},咈{違逆；乖戾}
fau2	fɐu35	不{同否字},缶,殕{物敗也},否{否定}
fau4	fɐu21	浮{浮動，輕浮},衃{蚍衃},蜉,芣,罘,琈,涪
fau6	fɐu22	埠{商埠，開埠，蚌埠市，讀同阜；〈又〉埠頭，船埠},阜
fe1	fɛ55	啡{(語)擬風聲，風～～吹；屙啡[fɛ21]～，拉稀；〈外〉茄哩啡，龍套、小角色，英語carefree}
fe2	fɛ35	㹃{(語)褦[lɛ24]～，同褦襶；指女子妖豔不正經},飛{(外)鈔票、錢，英語fare}
fe4	fɛ21	啡{(語)擬風聲，風吹～～；屙～啡[fɛ55]，拉稀}
fen1	fɛn55	番{(白)幾番，罕讀},翻{(白)～開}
fet1	fɛt5	唿{(白)～～，哨子；風～，時髦；符～，符籙，引申爲戲法、把戲，一說本字法，另一說本字節},艴{(白)紅～～，（面色）紅潤}
fet6	fɛt2	咈{(白)象聲詞，鼻涕～～，吸鼻涕貌，哭～～，抽泣貌}
fi1	fi55	啡{咖啡，嗎啡},鯡,騑,飛{飛機；～髮，理髮；票，買～，買票；阿～，青年流氓（後起詞）},非,霏,蜚{蜚語},菲{芳菲},緋,扉,妃
fi2	fi35	匪,誹,蜚{蜚廉},菲{菲薄},翡{翡翠},篚,痱{痱子，熱痱},疿{痱子},榧{香榧},棐,朏{朏明，朏魄},斐,悱
fi4	fi21	啡{(語)～～吙[fɔ22]吙[fɔ22]/䬍[fɔt2]䬍[fɔt2]，形容工作緊張},腓,肥,痱{中風病},淝
fi6	fi22	剕,狒
fik1	fek5	揊{(白)甩，與摒對轉，俗字𠱥},𠱥{甩，本字揊，擊聲，與捹/摒對轉}
fing3	feŋ33	姘{(白)屌你老～㞓，詈語},摒{(白)甩，與揊對轉，俗字捹},捹{甩，本字摒，除也，與𠱥/揊對轉}
fit1	fit5	撇{(白)抽打，～一鞭，俗字𢝵/𢞵}
fiu3	fiu33	覅{吳語字，弗要}
fo1	fɔ55	嵙,髁,蝌{(文)},窠{窠巢，窠臼},科{理科，科學}
fo2	fɔ35	伙{伙食},鈥,火,夥{夥伴},吙{吐氣；吐氣聲}
fo3	fɔ33	課{(文)},騍{(文)},貨
fo4	fɔ21	吙{(語)～～聲，熟睡聲、火旺貌、風嘯聲}
fo6	fɔ22	吙{(語)啡[fi21]啡[fi21]～～，形容工作緊張，本字䬍}
fong1	fɔŋ55	坊{街坊；作坊；地名，三坊街},鈁,邡,謊{說謊，謊話},蚄,荒,芳,肪{脂肪},肓,牥,枋,方,慌
fong2	fɔŋ35	仿{相仿，仿效（倣傚），仿佛（髣髴）},髣{髣髴},謊{(又)},訪,舫,紡,滉,榥,晃{晃眼；搖晃},昉,恍,彷{彷彿},幌,倣{倣傚}
fong3	fɔŋ33	放
fong4	fɔŋ21	坊{堤坊},鰟{同魴字},魴,防,房{房屋},妨{妨害}
fot6	fɔt2	䬍{(語)風聲；啡[fi21]啡[fi21]～～，形容工作緊張}
fu1	fu55	伕{車伕，拉伕},麩{麩皮},骷{(文)},鈇,鄜,郛,軤,跗{跗面},趺,莩{葭莩},膚,稃{穀皮},砆,玞,烀,滹,桴,枹{鼓槌},枯{(文)},敷,挎{執持},戲{於戲},幠,孵{孵化},孚,夫{夫妻},垺{同郛字},嘑{同呼字},呼{呼吸，歡呼，嗚呼},呋,刳,俘{俘虜}
fu2	fu35	㕮,黼{(又)},頫,釜,輔{(又)},虎,莆{萐莆},苦{辛苦},腑,簠,琥,父{尼父，田父；〈白〉舅父},滸{水滸},滏,殕{(又)},斧,撫,拊,府,嘸{驚愕},唬,俯,䋨
fu3	fu33	副,賦,褲,袴,絝,戽{戽水，戽斗},庫,富,嘑{嘑爾},咐{吩咐，囑咐}
fu4	fu21	乎{(又)},鳧,蚨,苻,芙{芙蓉},符,榑,扶,夫{悲夫}
fu5	fu24	婦{(又)},負{(又)負氣}
fu6	fu22	㳇,鮒,駙,附,赴{奔赴，赴會},賻,負{負擔，勝負，負氣},訃{訃告，訃聞},蝜,腐,秿{禾捆},祔,父{父母，伯父},嬔{同嬎字，兔崽},嬎{兔崽},婦{婦女，媳婦},傅{師傅；姓},付{交付，付款},仆{頓也；前仆後繼，又作赴字}
fui1	fui55	咴,顝,詼,虺{虺隤},盔{(又)},灰,悝{嘲笑；詼諧},恢,徽
fui2	fui35	悔,鮪,賄{賄賂，行賄},誨{(又)讀同悔},痏,洧,晦{(又)讀同悔}
fui3	fui33	喙,餯,顪,靧,誨{教誨},晦{晦暗，晦氣}
fuk1	fʊk5	复{行故道；同復/複字},鰒,馥,輻,覆{覆蓋，傾覆},複{複雜，重複},蝮,蝠{蝙蝠（口語用飛鼠或蝠鼠）},腹,福,畐,復{(習)復原；復興，古讀去聲，扶富切},幅
fuk6	fʊk2	伏{埋伏，伏案},襆,袱,菔,茯,縛{束縛，作繭自縛},洑,栿{房樑},服,復{(書)},幞{幞頭},宓{姓},匐
fun1	fun55	嚾{同歡字},髖,貛,獾,歡,懽{同歡字},寬{寬敞，與闊對轉}
fun2	fun35	款,窾
fung1	fʊŋ55	丰{丰姿，丰采},飌,風,鋒,酆,豐{豐收，豐富},蜂,葑{蕪菁},碸,瘋,烽,灃,渢{(又)},楓,崶,峰{同峯字},峯{山峯，峯巒},封
fung2	fʊŋ35	俸{(又)},諷{諷刺，譏諷},唪{唪經}
fung3	fʊŋ33	葑{菰根},賵
fung4	fʊŋ21	浲,馮{姓},逢{相逢；～係，凡是},舽{船名},縫{(動)縫補},渢
fung6	fʊŋ22	俸{俸祿},鳳,縫{(名)裂縫，俗讀縫補之縫},甮,奉
fut3	fut3	眓,闊{開闊，與寬對轉},适{疾速},豁{豁然},蛞{蛞蝓，蛞螻},筈{(又)}
fut6	fut2	䬍{(語)又音，風聲}
gaa1	ka55	㹢,鎵,迦,跏,袈,葭,茄{雪茄},笳,癿{(又)},痂,珈,泇,枷,旮{(語)～旯[la55]頭，苤藍或苤藍的莖},尜{(又)},尕,家{家庭，商家；〈語〉～下、而～，現在，本字今，受下字逆同化失去韻尾},噶{譯音用字，噶倫},嘎{象聲詞，裂聲、笑聲；嘎吱},嘉,加{加法，更加（口語省略作加）},傢{傢俱，傢伙},伽{伽利略}
gaa2	ka35	假{真假},賈{姓},瘕{腹內結塊},檟,斝,嘏{(又)},叚{借也，後作假}
gaa3	ka33	㗎{粵字，語氣詞，嘅啊的合音，本地不合音，常弱讀爲嘅[ɛ33]啊[a22]，佢（渠）好高～},駕{(文)},稼,架{(文)吵架},嫁,咖{咖喱},價,假{(文)},价{同價字}
gaa4	ka21	嘎{嘎調，嘎嘎兒},尜{尜尜兒}
gaa6	ka22	架{(語)丟～，丟臉，一說本字掉價}
gaai1	kai55	佳,階,鍇{(又)},街,薢,稭{麥稭},秸{麥秸，秸稈},皆,痎,湝,楷{楷樹；〈又〉楷書},嚌{嚌嚌},喈,偕{(又)}
gaai2	kai35	檞,解{解開}
gaai3	kai33	介,𠝹{同鎅字},骱{骨節間銜接處},鎅{鋸斷，本字解},誡,解{押解；鋸斷，俗字鎅/𠝹},蚧,芥,疥,界,玠,戒,悈,廨{(又)},屆,尬{尷尬},价{善也；僕役；介紹}
gaak3	kak3	嗝,鬲{鬲津，膠鬲},骼,革,隔,鎘{金屬元素},鉻{古兵器},茖,膈,胳{胳臂；～肋底，腋窩，弱讀爲[kɐ33/kə33]},滆,格,挌{擊也},塥
gaam1	kam55	尷{(又)},緘{緘口，緘默；古人名，蘇緘},監{監視，坐監}
gaam2	kam35	感,鱤,澉,減{(文)},橄{橄欖},敢
gaam3	kam33	尷{尷尬，後字調類化},鑒{鑒定},鑑{銅鑑，印鑑},監{太監，國子監}
gaan1	kan55	奸{奸詐，內奸},間{(文)},菅,艱{(文)艱苦，艱辛},姦{(文)}
gaan2	kan35	堿{(文)},鹼{(文)},鹻{(文)},鐧{(文)},趼{(文)},襉,茧{(文)},繭{(文)},簡{(文)},筧{引水的長竹管},礆{(文)},碱{(文)},梘{(文)},柬{(文)},暕{陰雨後晴},揀{(文)}
gaan3	kan33	澗,間{(文)間隔，離間，常讀},鐧{車鐧},諫
gaang1	kaŋ55	庚{(罕)},耕{耕田，春耕},羹{(又)匙羹},粳{(罕)},畊,更{三更}
gaang3	kaŋ33	徑{(白)～水，涉水，俗字浭},筻,浭{～水，涉水，本字徑},挭{攪拌；撈；～手，詠春八手之一}
gaang6	kaŋ22	俇{(語)打露～，裸下身}
gaap3	kap3	䀫{眼細暗；目睫動},餄{餄餅},頰,鋏,鉿{陷聲},鉀,郟,跲,裌{裌衣，裌裙},袷{袷衣},蛺,莢{(文)},胛{肩胛},甲{甲子，盔甲},浹{(又)汗流浹背},梜,柙{木名},挾{(文)},岬,夾{(文)夾層，夾竹桃；夾硬（強行）；夾衣，又作裌衣}
gaap6	kap2	蛤{(語)～～，大青蛙，童語，元音象義}
gaat3	kat3	嘎{象聲詞，鴨聲、雁聲},釓{金屬元素},擖{刮聲；斬斷},戛{戛然，戛戛},恝,尜{(又)}
gaat6	kat2	曱{～甴，蟑螂，本字甲蚻，前字受後字逆同化}
gaau1	kau55	交{(文)成交，外交，交通，交關},鵁{(文)},鮫{(文)馬鮫，馬鮫魚},郊{(文)市郊，城郊},轇{(文)},跤{(文)},蛟{(文)},茭{(文)},艽{(文)},膠{(文)},教{令、使、讓},峧{(文)},嘐{(文)}
gaau2	kau35	佼,餃{(文)餃子},絞{(文)},皎,狡{(文)},攪{(文)},搞,恔{狡黠},姣{(文)}
gaau3	kau33	教{(文)},鉸{(文)},較{比較；〈語〉～腳，逃走、溜走},覺{(文)睡覺},窖,漖{水名；地名用字},滘{河道相通處，本字漖；地名用字},校{校對，上校；校椅鎮；〈又〉學校},斠{斠訂，斠補}
gaau6	kau22	攪{(語)摎[lau35]～，胡搞；糟糕、凌亂}
gai1	kɐi55	㚻,鷄{同雞字},雞{雞蛋，小雞；〈語〉躲～、躲蒙[mʊŋ55]～，捉迷藏，該詞中又讀[ki55]，俗作躲機、躲蒙機},給{(語)表使役、與格或被動，官話借詞，二十世紀五六十年代產生},笄,機{(語)打火～；焫～，烙鐵；勾～，扳機；～頭，車頭（戲稱）},枅
gai2	kɐi35	偈{(語)傾～，聊天，一說本字傾蓋；大～，大副},計{(白)諗（恁）～，想辦法；扭～，鬧彆扭}
gai3	kɐi33	檵,髻,計{計算},薊,罽,繼,瀱
gai6	kɐi22	偈{佛偈},忌{(語)怕}
gak6	kɐk2	硌{(白)卡、阻擋，與梗對轉}
gam1	kɐm55	今,金,苷,疳,甘,泔{泔水},柑{柑橘，柑果}
gam2	kɐm35	噉{粵字，表狀態，這樣/那樣，箇物（箇麼）的合音；又表程度，這麼/那麼，本地統用噉，未分化出咁},錦
gam3	kɐm33	㽏,趛{(又)},贛{贛江},紺,禁{禁止；禁不起，情不自禁},淦,噤,咁{粵字，表程度，這麼/那麼，箇物（箇麼）的合音，本地統用噉，未分化出咁},僸
gam4	kɐm21	黚{(語)黃～～，暗黃色}
gam6	kɐm22	撳{按，本字𠢱},𠢱{按，俗字撳}
gan1	kɐn55	凧,釿,跟,筋,根,斤,巾,哏{逗哏，捧哏}
gan2	kɐn35	仅,饉,謹,緊,瑾,殣,槿,廑{小屋；覆蓋；同僅字},巹,墐{(又)},堇,僅
gan3	kɐn33	艮,靳,茛
gan6	kɐn22	墐,近{(文)近視，近排，將近},覲,歏
gang1	kɐŋ55	庚{年庚，庚子},鶊,賡,耕{(又)春耕},羹{羹湯，匙羹},縆,緪{繩索；繃緊，繃[mɐŋ55]得～，繃得緊},粳{粳米},畊{(又)},浭{水名},更{更換}
gang2	kɐŋ35	亙,𬒔{地名，石𬒔（在廣東）},鯁{(文)},骾{(文)},耿{耿直；〈語〉繃[pɐŋ35]～，古板},綆,梗{桔梗，梗阻；〈語〉～係，肯定是，箇肯的合音},埂{田埂},哽{哽咽；骨～在喉}
gang3	kɐŋ33	暅{曝曬},更{更加（口語省略作加）}
gang4	kɐŋ21	緪{(語)跌碽～，跌倒貌}
gap1	kɐp5	忣,蛤{(白)蛤蚧},芨{(又)},急
gap3	kɐp3	㪉,鴿{白鴿},頜{口；姓},閤{小門；姓},蛤{蛤蜊，蛤乸（田雞）},蓋{姓},敆,搿,合{容量單位，十合爲一升},佮{合夥，～錢，湊錢，又作敆/㪉字}
gap6	kɐp2	㧀,𥄫{盯住，本字䀫},𠶲{啃、咬，引申指吃},芨{白芨},岌{岌岌可危},及,䀫{(白)盯住，俗字𥄫}
gat1	kɐt5	㓤{刺，一說本字扢，擊也，另一說本字拮，戟也},郅{郅偈},詰{詰屈聱牙},訖{(又)},虼{虼蚤，虼螂},紇{紇繨},橘{(習)橘子，小金橘則俗作桔；註，柑橘（柑果）、金橘（金柑）、金桔（本地指西紅柿）同音但三者不同，易混淆，視語境區分},桔{桔梗；同橘字，多指小金橘，皮薄、黃色、味酸；註，金～，本地指西紅柿，與柑橘（柑果）、金橘（金柑）同音但三者不同，易混淆，視語境區分},姞,咭{笑聲},吉,吃{口吃},佶
gat6	kɐt2	䞘{直行；〈語〉～路，滾蛋，又作趷/趌字},𢷒{(語)擡、扛，翹起，本字揭，又作搩字},趷{同䞘字},趌{直行},疙{疙瘩；～𤶸，活結，引申爲摳門},曱{(又)},搩{(語)擡、扛，翹起，本字揭，又作𢷒字},揭{(白)擡、扛，翹起；拱～佬，搬運工},圪{圪墶}
gau1	kɐu55	佝{(文)},龜{龜茲},鳩{斑鳩；男陰，已罕用},鬮{拈鬮},韝,鉤{(文)},鈎{(文)},軥{(文)},緱,篝,痀{(文)},牞,溝,泃{水聲},摎{摎蓼},句{(文)},勾{(文)},勼{聚也}
gau2	kɐu35	久,韭,赳{(書)},苟,芶,耇{高壽},糾{(書)},笱,玖,狗,氿{湖名},枸,岣,九{九洲，九月；～長久、～長長（九諧音久），猜碼口令，數字九}
gau3	kɐu33	咎,雊,遘,購{(文)},詬,覯{(文)},究{研究，究竟},疚,灸{(文)},構{(文)},柩{(又)},构{(文)},救,彀{彀中，彀弓},廏{馬廏},廄{同廏字},媾{(文)},姤,夠,垢
gau6	kɐu22	䊆{(量)塊、團，俗字嚿},舊,柾,柩{靈柩},嚿{(量)塊、團，本字䊆}
ge1	kɛ55	爹{(訓)老[lau55]～，父親的口語敘稱，或源自官話老桿子，桿子的合音}
ge3	kɛ33	嘅{助詞，的，本字個}
ge6	kɛ22	忌{(白)怕},騎{(白)頭～，第一名；屘（蔑）[mɛt55]～，最後一名}
gem1	kɛm55	兼{(外)遊戲淘汰，英語game over}
gem2	kɛm35	減{(白)}
gem4	kɛm21	黚{(語)黃～～，中黃色}
gen1	kɛn55	姦{(白)強姦，姦淫},間{(白)中間，時間},艱{(白)艱難，艱鉅}
gen2	kɛn35	堿{(白)同碱字},鹼{(白)鹼性，燒鹼；肥皂，俗字梘},鹻{(白)同鹼字},鐧{(白)殺手鐧},趼{(白)足趼},茧{(白)同繭字},繭{(白)蠶繭；起繭},簡{(白)簡單},礆{(白)同碱字},碱{(白)鹼的俗字},梘{(白)通水器；肥皂，本字鹼},柬{(白)},揀{(白)揀選}
gen3	kɛn33	間{(白)間隔，離間，罕讀}
geng1	kɛŋ55	惊{(白)},驚{(白)},猄{(白)}
geng2	kɛŋ35	頸
geng3	kɛŋ33	鏡
geng6	kɛŋ22	儆{(白)～惜[ɬɛk3]，珍惜；～住，小心}
gep1	kɛp5	喼{～帽，鴨舌帽，英語cap；～鈕，按釦},篋{(語)皮夾子；手提箱；本字笈},笈{(白)皮夾子；手提箱}
gep3	kɛp3	挾{(白)挾菜},莢{(白)豆莢},甲{(白)指甲}
gep6	kɛp2	夾{(白)鐵夾；夾住},蛤{(語)～～，小青蛙，童語，元音象義}
geu1	kɛu55	交{(白)交錢，交往，交叉（該詞中又讀[kʰɛu55]）；爭～，吵架},鵁{(白)},鮫{(白)鮫魚，鮫人},郊{(白)郊外，郊區},轇{(白)},跤{(白)跌跤},蛟{(白)蛟龍},茭{(白)茭白},艽{(白)秦艽},膠{(白)膠水，膠擦（橡皮），膠箍（橡皮筋）},峧{(白)},嘐{(白)雞鳴}
geu2	kɛu35	姣{(白)姣好},餃{(白)餃子，水餃，粉餃},絞{(白)絞肉，絞死},矯{(白)矯詐，又作狡詐},狡{(白)狡猾，狡詐},攪{(白)攪動，攪拌}
geu3	kɛu33	教{(白)教書；教訓},鉸{(白)鉸刀；～剪，剪刀},覺{(白)睡覺}
geu6	kɛu22	撬{撬開}
gi1	ki55	乩,饑{饑荒},飢{飢餓},鞿,鐖{鉤上的倒刺},錤,譏,觭{偏向、側重；同奇字，單數},虮{密虮},萁{草名},肌,羈,箕,磯,畿,畸{(又)},璣,犄{犄角},機{飛機，機器},机,期{期年},幾{幾乎},己{(白)自己},姬,奇{奇數},基,嘰{嘰哩咕嚕},剞,刏{切斷},刉{同刏字},几{茶几},其{夜如何其；古人名，酈食其}
gi2	ki35	己{自己，知己},麂,魢,踦{腳脛},蟣{蟣蝨},虮{同蟣字},紀{紀律；世紀；姓},杞,掎,庋{(又)},幾{幾個}
gi3	ki33	冀,鱀,驥,記,計{夥計，又作夥記},覬,洎,暨{及也至也；暨南大學},旣,既,寄
gi6	ki22	伎{伎倆},鬾{冥衣},騎{車騎，鐵騎；姓},跽,芰,汥{水分流},技,惎,忌{妒忌，忌諱},妓{妓女},垍
gik1	kek5	亟{亟待},激,殛,棘{荊棘},擊{攻擊},撠,戟,墼
gik6	kek2	极,極
gim1	kim55	兼{兼職，兼顧},鶼,鰜{比目魚},蒹,縑,搛{搛菜}
gim2	kim35	撿,瞼,檢
gim3	kim33	劍
gim6	kim22	儉
gin1	kin55	堅{堅固，堅強；〈語〉優良的},鳽{鶺鴒},鰹,鞬,靬,鈃{人名用字},肩,樫
gin2	kin35	件{(白)條件},𠐻{傲慢},蹇,謇
gin3	kin33	建,見{看見},腱{肌腱，腱子，讀同建},犍{犍牛，犍子，讀同建},毽{(書)}
gin6	kin22	件{一件},鍵,踺,犍{犍爲縣，漢碑從木作楗},楗,揵{通楗字},健
ging1	keŋ55	京,麖,驚,荊,經{經濟；經緯},矜,猄{(文)},涇,惊{同驚字},兢
ging2	keŋ35	儆{儆戒，以儆效尤；〈語〉寵愛，得～，得寵；得意，見廣的合音，～溫七，得意洋洋},警,璥,璟,烴{溫；焦臭；焦貌},景{風景，景仰},擏{同儆字},憬,境,剄
ging3	keŋ33	勁{幹勁，費勁},逕,莖{根莖，讀同逕},脛,競{(常)競爭，競賽，讀同竟，又或後字調類化},竟{究竟，竟然},獍,敬,徑{半徑，徑直},弳
ging6	keŋ22	倞{強勁},競{競爭，競賽},痙,勁{強勁，勁敵；〈語〉厲害}
gip3	kip3	劫,袷{相交的衣領},蜐,澀{苦澀}
git3	kit3	㛃,鮚,袺,絜{清也，後作潔},結,潔,洁,拮,䥛{鐮刀}
git6	kit2	偈{武貌；疾馳},𠹳{（粥）稠，本字渴},竭{(白)（粥）稠，古字渴，俗字傑/𠹳},渴{(白)（粥）稠，後作竭，俗字傑/𠹳},榤,桝,桀,杰{人名用字；同傑字},搩,傑{傑出}
giu1	kiu55	嬌,驕,澆
giu2	kiu35	撟,蹻{蹻蹻},繳{上繳},矯{矯健，矯情，矯詐},皦,璬,敫{光閃耀；姓}
giu3	kiu33	叫,敫{人名用字},徼{邊界；巡察}
giu6	kiu22	嶠{山道},轎{轎車，花轎}
go1	kɔ55	仡{仡佬族},鎶,鍋,過{古國名；姓},菏{古湖名},滒,渦{渦河},歌{唱歌，歌曲},戈,堝,哥{阿哥，哥[kɔ21]哥},咼{姓}
go2	kɔ35	哿,𠜴,餜{餅也，餜子，清明餜},錁,裹,蜾,菓,舸,粿,笴{(又)},猓,果{水果，如果},嗰{粵字，那，本字箇，本地用嚕（遠指），偶爾也用不變調且不分遠近指的箇}
go3	kɔ33	個{一個，個人},過{過逾；過失},箇{量詞，枚也；代詞，這、那，～便、～啲、～幾個，不分遠近指}
go4	kɔ21	㰤{(語)打鼾聲，睡得～～聲，打鼻鼾響～～}
goe1	kœ55	啹{撅；噘},撅{(語)～屎胐，撅屁股，又作啹字},噘{(語)～嘴，噘嘴，又作鼓/啹字}
goek3	kœk3	屩{草鞋；高～瘸，高蹺，俗字腳},蹻{通屩字，高～瘸，高蹺},蹺{(語)高～瘸，高蹺，本字屩/蹻，俗字腳},腳
goeng1	kœŋ55	僵{(文)},韁{(文)},薑{生薑},繮{(文)},礓{礓石},疆{(文)邊疆，疆域},畺{(文)},殭{(文)},彊{(文)同疆字},姜{姓}
goeng2	kœŋ35	蔃{根、莖，一說梗的音變}
goeng6	kœŋ22	勥{固執，又作犟字},糨,犟{同勥字},滰
goi1	kɔi55	垓,隑{梯子},陔,賅,該,荄,胲{牲蹄},晐
goi2	kɔi35	改,胲{臉頰}
goi3	kɔi33	丐{(又)},蓋{瓶蓋；蓋被}
gok3	kɔk3	傕,閤{通閣字},閣{樓閣，閣下},鉻{金屬元素，符號Gr},角{牛角，角色},覺{(文)覺悟，覺醒，覺意（留意）},袼{袼褙},蟈{蟈蟈},虢{(又)},膕,硌{硌腳},珏,玨,漍,桷{榱桷，椽桷；～子，椽子},斠{平斗斛},擱{(文)},幗,國,咯{雞叫聲；咯噔},各
gon1	kɔn55	乾{乾燥，乾淨},酐{酸酐},虷{侵犯},肝,竿{竹竿},矸{矸石，丹矸},玕,漧,杆{旗杆，欄杆},干{天干，干涉，干脆}
gon2	kɔn35	扞{同擀字},趕,赶,笴,稈{稻稈，禾稈},桿{筆桿，桿秤},杆{筆杆，杆秤},擀{擀麪}
gon3	kɔn33	幹{骨幹，幹勁，幹部},簳,矸{山石貌},榦{同幹字},旰{宵衣旰食}
gong1	kɔŋ55	㿠,阬{大山坡},鋼{(又)鋼鐵，鋼筆},釭,輄,豇{豇豆},茳,舡{(又)},胱,肛,罡,缸,綱,笐{竹列},矼,瓨,珖,玒{(又)},洸,江,棡,桄{(文)桄榔},杠{牀前橫木},摃,掆{擡、扛},扛{力能扛鼎},崗,岡,堽{地名，長堽嶺},垙,咣,剛,冮,光,亢{人頸}
gong2	kɔŋ35	广{同廣字},講,耩{耩地},獷,港{港口},桄{(白)桄榔},廣
gong3	kɔŋ33	杠{杠桿，單杠},鿍,降{下降},鋼{鋼鐵，鋼筆，不鏽鋼；鋼一鋼},虹{(白)雙～，兩道彩虹},絳,洚,槓{同杠字，槓桿，單槓},桄{桄子；一桄線}
gong6	kɔŋ22	逛{(文)}
got3	kɔt3	㖵,葛,噶{象聲詞},割{分割，割禾}
got6	kɔt2	嗗{(又)～～聲，吞咽聲；～酒，飲酒}
gu1	ku55	估{(又)估計},鴣{鷓鴣},高{高低，上高（上面）},酤,辜,軲,觚,蛄,菰,菇,苦{(語)苦力，英語coolie與其同源，俗作咕喱},膏{(名)牙膏},胍{胍𦘴},羔,罛,糕,篙{竹篙},睾{睾丸，附睾},睪{陰丸也，後作睾},皋,沽,櫜,槔,孤,姑,咕{咕嚕，咕嘟，嘀咕；花～嘟，花蕾、花骨朵},呱{呱呱墜地},古{(外)朱古力，英語chocolate}
gu2	ku35	䀇{䀇子},𦙶,鼓,鎬{鎬頭},鈷,賈{商賈},詁,蠱,蛌,藁,臌,股{股票，入股，屁股},羖,罟{網},縞,筶{義未詳},稿,瞽,盬{鹽池；盬子（湯皿）},牯,槁,果{(又)如果，語流音變},杲,嘏,咕{雞咕[ku21]～，雞崽，童語},古{古代},估{估計，低估；猜；；謎語，猜～，猜謎語，字～，字謎，開～，揭謎底}
gu3	ku33	估{估衣},鯝,顧,雇{雇主，雇員，解雇},錮{禁錮},鋯,郜,誥,膏{(動)膏車，俗讀牙膏之膏},筶{卜具},痼,故,崮,堌,固,告{告訴；忠告，古讀入聲，古沃切},僱{同雇字，僱傭，僱用}
gu4	ku21	咕{(語)雞～咕[ku35]，雞崽，童語}
gui6	kui22	䠩{累，俗作癐/攰字},癐{病也；〈語〉累，本字䠩},攰{累，本字䠩}
guk1	kʊk5	嚳,鵠{鵠的},鞫,鞠{鞠養，鞠躬（口語用曲躬）},鋦{鋦碗},轂,谷{山谷},菊,穀{五穀},牿,瀔,榖,梏,掬{雙手捧物}
guk6	kʊk2	侷{侷促},鋦{金屬元素，符號Cm},跼,焗{悶，～茶，沏茶，～熱，悶熱，一說本字焅，另一說本字局},局
gun1	kun55	倌,觀{參觀},蒄,莞{草名},棺,官,冠{衣冠}
gun2	kun35	䲘,館,莞{東莞},脘,管,筦,琯,朊{胃}
gun3	kun33	冠{冠軍},鸛,鑵,貫,觀{寺觀},罐,祼,盥,瓘,爟,灌,涫,毌
gung1	kʊŋ55	䢼,龔,釭{(又)},躬{鞠躬，曲躬，躬親},蚣{蜈蚣},芎,紅{女紅},篢{篢笠},碽,玒{(又)},攻{攻擊},愩{心煩；恐懼},恭,弓,巭,工,宮,塨,功,公{公文，辦公；公公（外祖父），老公（丈夫）},供{供應，口供}
gung2	kʊŋ35	㧬,鞏{鞏固},珙,栱,拱{拱手；～揭[kɐt2]佬，搬運工}
gung3	kʊŋ33	供{供奉，供養},𫋐{鑽，拱出，與鞠對轉},貢,汞{水銀；紅汞，藍汞},愩{自我抬舉},嗊{嗊吥}
gung4	kʊŋ21	碽{(語)～～聲，轟轟響；跌～緪，跌倒貌}
gung6	kʊŋ22	共{總共}
gut6	kut2	嗗{象聲詞，飲水聲，引申作喝，～茶，喝茶}
gwaa1	kʷa55	呱{頂呱呱，呱呱叫},胍{有機化合物},瓜,歄{弱貌；〈語〉死亡}
gwaa2	kʷa35	剮,寡
gwaa3	kʷa33	卦,詿,褂,掛,挂,坬,啩{粵字，語氣詞，嘅哇的合音，本地用哇[wa22]，今日冇落雨～？}
gwaa4	kʷa21	呱{(語)象聲詞，吆～～，叫喳喳}
gwaai1	kʷai55	㔞{劥㔞},乖
gwaai2	kʷai35	拐{拐彎；拐棍},𧊅{俗字，蛙類},蒯{(又)},柺{同枴字，柺棍},枴{枴棍}
gwaai3	kʷai33	夬,怪
gwaak3	kʷak3	摑
gwaan1	kʷan55	瘝,鰥{鰥寡},關{(文)機關，關節，崑崙關；關閉，關心，關於；姓},綸{羽扇綸巾}
gwaan3	kʷan33	慣{(文)慣性},躀{摔，本字摜},擐,摜{扔；摔；跌}
gwaang2	kʷaŋ35	梗{(白)又音}
gwaang6	kʷaŋ22	俇{俇俇；遠行},逛{(白)逛街，遊逛}
gwaat3	kʷat3	刮{(文)},鴰,颳{(文)},聒{聒噪，聒耳},筈,栝{櫽；檜樹},括{包括，括號}
gwai1	kʷɐi55	傀{傀奇},龜{烏龜},鮭,閨,銈,邽,硅,皈,瑰{瑰寶},珪,潙,溈,洼{姓},歸,廆{山名},嬀,媯,圭
gwai2	kʷɐi35	佹,鬼,軌,詭,簋,氿{氿泉},晷,庋,宄,姽,匭,傀{(又)傀儡}
gwai3	kʷɐi33	劌,鱖{鱖魚},蹶{動也},貴,筀,癸{壬癸},瑰{玫瑰},炔{姓},炅{姓},桂,昋{姓},悸,季
gwai6	kʷɐi22	匱{匱乏},饋{反饋，饋贈，俗讀同潰},餽{餽贈},跪,蕢,簣,櫃{櫃檯},柜{同櫃字}
gwak1	kʷɐk5	搉{(白)又音，敲}
gwak6	kʷɐk2	𥕏{硬～～，硬邦邦}
gwan1	kʷɐn55	君,𧥺{(又)},龜{同皸字，龜裂},麇{獐子},鵾{(文)},鮶,頵{(又)},鋆{(又)人名用字},鈞{(文)},軍,謴{(又)},褌,莙,筠{地名，筠連（在四川）},皸{皸裂},均{(文)}
gwan2	kʷɐn35	滾,𥕦,鯀,輥,袞,緄{(文)}
gwan3	kʷɐn33	呁,𧥺{欺騙，又作謴字},謴,棍,捃{(又)}
gwan6	kʷɐn22	珺,郡
gwang1	kʷɐŋ55	揈{擊聲；驅趕},轟{(文)},輷{羣車聲},訇{象聲詞；阿訇},觥,薨{公侯之死},肱,硡{石落聲}
gwang4	kʷɐŋ21	訇{(語)詞綴，紅～～，深紅色}
gwang6	kʷɐŋ22	輷{(語)量詞，圈、繞；名詞，月～，月暈，日～，日暈}
gwat1	kʷɐt5	䓛{(又)},鶻{鶻鵃},骨{筋骨，骨頭},餶{餶飿},蓇,滑{亂也；〈書〉滑稽},汩,橘{(書)},榾
gwat6	kʷɐt2	㭾,𥏘,𡲬,掘{挖掘，掘地},崛,屈{(語)不尖，～尾雞，短尾雞，又作𡲬/𥏘/㭾字},倔{倔強}
gwe1	kʷɛ55	呱{(語)象聲詞，吆～～，叫喳喳}
gwe4	kʷɛ21	呱{(語)象聲詞，吆～～，叫喳喳}
gwen1	kʷɛn55	關{(白)關門，關燈}
gwen3	kʷɛn33	慣{(白)習慣}
gwet1	kʷɛt5	刮{(語)擬刮聲，（聲音）尖細、尖亮，聲好～、吆～～}
gwet3	kʷɛt3	刮{(白)刮傷，搜刮},颳{(白)颳風},擖{(訓)用刀刮，～松油，訓讀刮},括{(白)罕讀}
gwik1	kʷek5	洫,鶪,馘,闃,虢{假途滅虢，虞虢；姓},綌,湨
gwing1	kʷeŋ55	坰,駉,扃
gwing2	kʷeŋ35	冏,迥{迥然不同},詗,絅,熲,炯,炅{火光；明亮},泂,囧
gyu1	ky55	俥{象棋紅方棋子名},駒{(文)},車{車馬炮},裾,腒,琚,椐,据{拮据},崌,居
gyu2	ky35	妓{(語)妓女的合音，老～，老妓女，俗作老舉},齲,踽,襷,蒟{蒟蒻},莒,舉,筥,矩{規矩},櫸,榘,柜{柜柳},弆
gyu3	ky33	倨,鋸{〈名〉鋸子；〈動〉鋸開},踞,瞿{驚視},據{根據，據說},据{同據字},屨,句{句子，語句}
gyu6	ky22	俱{俱全，俱樂部，傢俱},颶,鉅{艱鉅，鉅額；姓},醵,遽,距{(又)},詎,苣,窶{貧窮},秬,犋,炬,澽,據{(又)據說},拒{(又)},懼,巨{巨大，巨人},岠,姖,具{具體，工具}
gyun1	kyn55	娟,鵑,蠲,蜎{(語)爬着鑽},絹{手絹，絹絲},焆,涓,捐
gyun2	kyn35	卷{試卷，卷軸},錈,捲{捲起，捲曲}
gyun3	kyn33	券{(習)票券，證券},鄄,絹{(又)},睠{同眷字},睊,眷{家眷；眷顧},狷,桊,圈{豬圈}
gyun6	kyn22	倦
gyut6	kyt2	橛{量詞，截，又作橜字}
haa1	ha55	㗇{欺負，一說本字諕/謑/訶},𨉣{𨉣腰},閜{大開},閕{門閉也},鉿{金屬元素，符號Hf},蝦{魚蝦},瘕{掹（絣）～，哮喘},岈{㟏岈},哈{哈哈笑；哈巴狗；哈腰，同𨉣腰；姓},吓{嘆詞}
haa2	ha35	下{(又)鄉下，地下（地上；樓底）}
haa4	ha21	叚{通瑕/遐字；姓},霞,遐,蝦{蝦蟆，又作蛤蟆},蛤{蛤蟆，同蝦蟆},瑕,哈{(又)笑～～，元音象義；～一口氣}
haa5	ha24	下{一下，等下，語流中易讀陰去},奤{奤夿屯},吓{同下字}
haa6	ha22	下{底下，下山；鄉下，地下},雫,暇,廈{大廈；廈門},夏{春夏；姓}
haai1	hai55	咳{嘆詞},揩{揩油},嗨{嗨喲}
haai4	hai21	偕{白頭偕老},骸{骸骨},鞋,諧,磑{(白)粗糙，疑匣旁轉，俗字嚡},孩,嚡{粗糙，本字磑}
haai5	hai24	懈{鬆懈，懈氣},駭{驚駭},邂,觟{觟䚦},蟹{螃蟹，青蟹，花蟹},薢{(又)},獬,澥,檞{(又)}
haai6	hai22	嗐{(又)嘆詞},齘,解{曉也、姓，俗讀解開之解},薤,瀣,械{機械},廨
haak3	hak3	吓{同嚇字},赫{赫赫有名，顯赫},揢{以手把着},客,嚇{嚇一跳；恐嚇},喀{喀斯特，喀秋莎}
haak6	hak2	垎
haam1	ham55	憨{憨厚}
haam2	ham35	闞{虎聲},餡{(白)}
haam3	ham33	㘚{(文)},闞{犬聲},喊{(文)}
haam4	ham21	函,鹹{(文)},銜,諴,涵,崡,啣,咸{咸豐，咸陽，老少咸宜}
haam5	ham24	菡
haam6	ham22	㽉{大瓮},餡,陷,撼{震撼},憾{遺憾}
haan1	han55	慳{節省，～食～使，省吃儉用},臤{堅固},羥{羊名},掔
haan4	han21	嫺{嫺熟，嫺靜},鷴{同鷳字},鷳{白鷳},閒{(文)清閒，閒置},閑{(文)防閑；通閒字，清閑，閑置},癇,嫻{同嫺字}
haan6	han22	硍,限
haang1	haŋ55	劥{劥㔞},阬{同坑字},夯{石夯，夯實},坑
haang4	haŋ21	行{行路，步行}
haap3	hap3	呷{大口喝，又作欱字},袷{袷袢},莢{(語)菜～，老菜葉},狹{(常)狹窄，後字調類化},欱{大口喝，又作呷字；打～浪，打哈欠},掐{掐住，掐指},挾{(又)挾持，讀同狹},恰{恰當，恰似},嗑{嗑然而笑}
haap6	hap2	俠,陜,翈,篋{(訓)書篋，籐篋，訓讀匣},硤,狹{狹窄，狹小},狎,炠,洽{洽談，融洽},柙{藏獸檻},峽{峽谷，海峽},匣{匣子，木匣}
haat3	hat3	瞎
haau1	hau55	哮,骹{小腿},酵,鄗{古山名},虓,薅{(白)薅草，薅田},茠{(白)同薅字},礉{同䂭/磽字},磽,猇,烤,毃{同敲字},敲{敲門},尻,嚆,嘐{誇語；啁嘐}
haau2	hau35	巧{(文)巧合，技巧，巧克力，七巧節},考,洘,栲,攷{同考字},拷
haau3	hau33	孝,礉{石不平貌},涍,校{(又)學校}
haau4	hau21	姣{(文)}
haau6	hau22	傚{倣傚},滧,校{學校},斆{教導},斅{教導},效{成效，效果},恔{暢快}
hai1	hɐi55	㞓{女陰（即谿，山間河），俗字閪},閪{女陰，本字㞓（即谿，山間河）}
hai2	hɐi35	喺{粵字，在，本字在，老派用打}
hai4	hɐi21	傒{(文)},鼷{(文)},騱{(文)},郋,蹊{(文)蹊徑},徯{(文)},嵇{(文)},奚{(文)},兮
hai6	hɐi22	係{關係；是},繫{連繫；繫鞋帶，古讀古詣切},系{系統},禊
hak1	hɐk5	克{(文)西哈努克，巧克力，多用於人名物名},𨭆,黑,赫{(又)},氪{(文)},可{可汗},剋{(文)},刻{(文)}
hak6	hɐk2	閡{(語)打～呃，打嗝，又可省略作打呃}
ham1	hɐm55	坩,龕,魽{同蚶字},顉{曲頤；低頭也},鑫,酣{酣睡},蚶{蚶子，毛蚶},歆,欽,欣{(常)欣賞，讀同欽},戡,廞,嶔,嵁,堪
ham2	hɐm35	坅{坑},𧾏,顑,轗,莰,臽{舂～，石臼，又作坎字},砍{刀砍，砍伐},欿{貪},扻{磕、碰，與磕對轉},埳,坎{坎坷，心坎；舂～，石臼，又作臽字}
ham3	hɐm33	勘{勘探，勘誤},闞{姓},磡{巖崖之下},瞰,嵌,崁,墈{險岸}
ham4	hɐm21	含,魽{蛤},酣{(又)},琀,焓,浛,晗,嵅,唅{通含/琀字；〈語〉詞綴，衝/追/趯～～，着急往前衝/追/跑}
ham5	hɐm24	撖{姓},頷
ham6	hɐm22	冚{～唪唥，全部，一說本字咸}
han2	hɐn35	墾,齦{啃},豤,詪,狠,懇,很
han3	hɐn33	睏{(白)拜眼～、瞌眼～，打瞌睡}
han4	hɐn21	拫{牽引},痕{傷痕；癢}
han6	hɐn22	恨
hang1	hɐŋ55	亨{亨通，大亨},鳽{鵁鶄},鏗{(文)},硜,摼{敲打},啈{嘆詞},哼{哼唱},吭{不吭聲}
hang2	hɐŋ35	啃{(文)},肯{肯定，中肯}
hang4	hɐŋ21	姮,鴴,衡{平衡；〈語〉繃緊，俗字拫},行{行爲；品行，古讀去聲},蘅,珩,桁{桁條，瓦桁},拫{(語)繃緊，本字衡},恒,恆
hang6	hɐŋ22	倖{倖免，倖存},莕,荇,杏,悻,幸{幸福，榮幸},婞,堼
hap1	hɐp5	㝓{同䆟字},𧬈{欺負},磕{(白)磕碰，磕頭，與扻對轉},瞌{(白)小睡；合眼},匼{匼匝；匼河（在山西）},䆟{合也}
hap3	hɐp3	恰{(又)}
hap6	hɐp2	合{合作},𬌗,餄{餄餎},頜{上下頜},闔,閤{同闔字},鉿{鉿匝，同匼匝},郃,耠,磕{(文)},瞌{(文)},盒{禮盒，菸盒},盍,烚{㷫～～，熱烘烘},溘,洽{(又)},搕{敲擊；取},峇{岌峇},嗑{噬嗑；嗑瓜子；嘮嗑}
hat1	hɐt5	乞{乞討，乞兒},迄{(又)},訖{(又)},汔{(又)},忔{喜也},屹{(又)},嗐{(白)打～鍬，打噴嚏},喫{(又)},吃{(又)}
hat6	hɐt2	劾,齕{齧也},黠{狡黠},閡{隔閡},轄{管轄},覡,覈{覈對},葜,翮,紇{回紇},籺,礉{苛刻、嚴峻；同覈字},檄,核{核桃，核心，核武器；同覈字},嗐{大開口}
hau1	hɐu55	候{(白)盯着，留意，俗字睺},齁,睺{盯着，留意，本字候}
hau2	hɐu35	口,吽{同吼字},吼{吼叫}
hau4	hɐu21	侯{王侯；姓},骺,餱,鍭,篌,睺{半盲},瘊{瘊子},猴,喉
hau5	hɐu24	厚,垕{同厚字；姓}
hau6	hɐu22	候{守候，等候},鱟,鮜,郈,逅,後{先後，後來},堠,后{皇后}
he1	hɛ55	哈{(又)笑～～，又作嘻字},嘻{(又)笑～～，又作哈字}
he3	hɛ33	㹃{撬，～開隻櫃},氣{(白)離[lɛ21]～，不修邊幅}
he4	hɛ21	哈{(又)笑～～，元音象義，又作嘻字},嘻{(又)笑～～，元音象義，又作哈字}
hek3	hɛk3	吃{吃飯，小吃，本字喫},喫{(文)}
hem3	hɛm33	㘚{(白)},喊{(白)}
hem4	hɛm21	鹹{(白)鹹淡，鹹魚，鹹菜}
hen1	hɛn55	慳{(白)節省；歇息，～一下}
hen2	hɛn35	蜆{(白)蜆子，蜆肉；～殼，小蛤蜊},齦{(白)啃，老鼠～}
hen4	hɛn21	閑{(白)通閒字，得閑},閒{(白)得閒}
hen6	hɛn22	莧{(白)莧菜}
heng1	hɛŋ55	輕{(白)輕重，輕[hɛŋ21]～}
heng4	hɛŋ21	贏{(罕)}
het6	hɛt2	勩{(語)器物磨損}
heu1	hɛu55	敲{(白)},蹻{(文)},蹺{(文)},翹{(文)翹腳},繑{(文)},橇{(文)}
heu4	hɛu21	姣{(白)淫蕩}
hi1	hi55	俙,鱚,魌,釐{同禧字},醯,郗{骨節間；姓},豨,譆,誒{可惡之辭；強笑},羲,絺{(又)},稀,禧,睎,琋,犧,爔,熹,熙,烯,浠,欺,欷,榿,曦,晞,戲{(白)兒～，不可靠，又作兒嬉},希,巇,嬉{嬉戲，嬉笑；兒～，不可靠，又作兒戲},娭{通嬉字},嚱,嘿{嘆詞；象聲詞，笑嘿嘿},嘻,唏{唏噓},兮{(又)},僖
hi2	hi35	喜,𨭎,起,豈,蟢{蟢子},芑,玘,暿,憙,屺
hi3	hi33	㞓{臀部；身體斜坐},餼,炁,汽,氣{空氣，氣人},气{同氣字},棄,摡{取也},戲{戲劇},憩,屭,屓,器,咥{大笑貌}
hi4	hi21	嘻{(又)笑～～，元音象義}
hik1	hek5	吃{(又)},喫{(又)}
him1	him55	忺{高興；舒適},𣔙{同杴字},鍁{同杴字},謙,磏{地名，大磏（在貴州）},杴{農具名，又作𣔙/鍁字}
him2	him35	嶮,險,肷,玁,獫
him3	him33	慊{怨恨},芡{芡實，勾芡},歉{道歉，歉意},欠
him4	him21	嫌{(白)}
hin1	hin55	岍,𣔙{(又)},鶱,騫,鍁{(又)},軒{軒昂，軒轅},諐,褰,臤{(又)},縴{縴夫},祆,牽,汧,杴{(又)},攑,攐,搴{取也},掔{(又)},掀{掀起，與揭對轉},愆
hin2	hin35	㬎,𩝡,顯,遣,譴,蜆{(文)蜆木},繾,櫶{櫶木，即蜆木},䭤,䘆{蚯蚓}
hin3	hin33	憲,獻{貢獻，獻出；～世，丟臉、出醜，源自現世}
hing1	heŋ55	兄,馨,輕{(文)輕佻，輕敵},興{興旺},氫,卿
hing3	heŋ33	㷫{熱、燙},謦,詗{(又)},興{高興},罄,綮{肯綮},磬{鐘磬},敻{遠},慶,夐{遠}
hip3	hip3	䁋,脇,脅,搚{(又)},挾{挾持，挾帶},慊{滿足},愜,怯{畏怯},叶{同協字，叶韻},協{協助},勰
hit3	hit3	挈{(又)帶～，提攜、關照},蠍{(文)},蝎{(文)},歇{歇息，停歇}
hiu1	hiu55	僥{僥倖},鴞,驍,梟,枵,徼{徼倖},囂,嘵
hiu2	hiu35	曉
hm1	hm55	噷
hng6	hŋ22	哼{嘆詞},啈{發狠聲}
ho1	hɔ55	㰤{同呵字},訶,抲{指揮},嚯,嚄{嘆詞},呵{呵欠，呵斥；地名，呵叻（在泰國）}
ho2	hɔ35	可{可以},閜{閜砢},舸{(又)},炣,岢,坷{坎坷；坷垃},哿{(又)}
ho4	hɔ21	何,蚵,菏{地名，菏澤（在山東）},荷{荷花；薄荷，又作蔢𦽅},河,嗬{嘆詞；象聲詞；～哆[tɛ55]，嗩吶},和{(語)連詞，我和你，官話借詞}
ho6	hɔ22	荷{荷載},賀
hoe1	hœ55	㗾{起鬨，本字噓},靴,吙{(又)}
hoe2	hœ35	㗾{㗾[hœ21]～聲，㗾[hœ21]～滾，熱鬧貌}
hoe4	hœ21	㗾{～㗾[hœ35]聲，滾～～，熱鬧貌},嗬{(又)～哆[tœ55]，嗩吶}
hoeng1	hœŋ55	薌{穀香},香,鄉{鄉村，故鄉}
hoeng2	hœŋ35	享,饗,餉{軍餉},響,晌{晌午},垧,亯
hoeng3	hœŋ33	向{向前，方向},珦,曏{從前},嚮{嚮導，嚮往}
hoet6	hœt2	吷{(語)氣～～，氣喘吁吁}
hoi1	hɔi55	咍,開,鐦
hoi2	hɔi35	凱{(文)},闓{(文)},鎧{(文)},醢,胲{有機化合物的一類},海,愷{(文)},塏{(文)},剴{(文)}
hoi4	hɔi21	咳{嬰兒笑},骸{(常)骸骨},頦
hoi6	hɔi22	亥,駭{(常)驚駭},氦,害,嗐{大開口；嘆詞}
hok3	hɔk3	殼{蛋殼；地殼},郝{姓},蠚{螫也},熇{熱貌，與炕對轉}
hok6	hɔk2	學{上學，學校，同學},鶴,隺,貉{貉子，貉絨},翯,斆{學},斅{學},嶨
hon1	hɔn55	看{看守，看管},頇
hon2	hɔn35	侃,蔊{(又)},罕,刊{報刊，刊誤}
hon3	hɔn33	厂{山石之崖},衎,翰{(又)},看{看見，看法},熯{火乾},漢,暵
hon4	hɔn21	寒,韓,邯{邯鄲},邗,虷{井中赤蟲},犴{駝鹿},汗{可汗，汗國},榦{井欄}
hon5	hɔn24	旱{乾旱，旱災}
hon6	hɔn22	垾,鼾,銲{同焊字},釬{同焊字},蔊,翰{翰林，翰墨},矸{磓},犴{(又)狴犴},焊{焊接，電焊},瀚,汗{出汗},旰{皓皓旰旰},撼{(又)},捍,扞{扞格；同捍字},悍
hong1	hɔŋ55	㝩,𡐓,鱇,躿,腔{口腔，腔調},糠{米糠，糟糠；糠蘿蔔},穅,砊{雷聲},漮,慷{(文)},康
hong2	hɔŋ35	巷{(白)街巷},項{(白)項鏈，強項，一項},衖{同巷字，街巷},糠{(白)陳米氣味；（皮膚等）缺油乾燥；又作粇字},穅{(白)}
hong3	hɔŋ33	炕{烘烤，～火，與熇對轉}
hong4	hɔŋ21	吭{引吭高歌},頏,降{投降},行{銀行，行列},航,肮{喉嚨},絎,笐{樂器},沆,桁{刑具},杭
hong5	hɔŋ24	酐{苦酒}
hong6	hɔŋ22	巷{(文)地名，石巷口},𣚺{～雞（舊又作雞～），小母雞，又作項字，本字笐（竹列也）},項{項目；〈語〉～雞（舊又作雞～），小母雞，本字笐（竹列也）},笐{衣架；〈又〉竹列；〈語〉～雞（舊又作雞～），小母雞，俗字項/𣚺},桁{衣架}
hot3	hɔt3	喝{喝酒；喝采},𦤦,鶡,餲{餅類食品},鞨{鞋；靺鞨},褐,蝎{木中蠹蟲},渴{口渴，渴望},曷
hu1	hu55	呼{(白)嗚[∅u55]呼，表無奈或嘲諷，俗字噢/哦呵},薅{(文)},蒿{蓬蒿，茼蒿},茠{(文)}
hu2	hu35	好{好壞}
hu3	hu33	呵{(語)哦/噢～，表無奈或嘲諷，本字嗚呼},耗{消耗，耗費},秏,好{喜好},呼{(白)又音}
hu4	hu21	嗥,豪,蠔,蚝{同蠔字},號{呼號，俗讀號碼之號},濠,毫,壕,嚎
hu6	hu22	昊,顥,鎬{鎬京},鄗{古地名},號{號碼},皞,皓,灝,滈,淏,浩
huk1	hʊk5	哭
huk6	hʊk2	學{(又)學校，同學，語流音變},𤌍,鵠{鴻鵠},酷{殘酷，酷愛},觳{觳觫},縠,焅,槲,斛
hung1	hʊŋ55	倥{倥侗},訩,胸,箜,空{空虛；空缺},硿,烘{烘乾},洶,悾,崆,埪,哅,哄{亂哄哄，哄堂大笑，一哄而散},吽{唵嘛呢叭咪吽},匈,匂,凶{吉凶},兇{兇惡}
hung2	hʊŋ35	倥{倥傯},愩{心神恍惚},恐{恐怕，恐龍},孔{孔雀，鑽孔；姓},嗊{羅嗊},哄{哄騙，哄勸},吼{(又)讀同孔}
hung3	hʊŋ33	嗅{(又)用鼻聞},齅{(又)},空{抽空，得空；〈又〉空缺},烘{(又)},控{控制，失控}
hung4	hʊŋ21	吰,黌{黌舍，黌門},鴻,雄,閎,鋐,鉷,谼,訌{內訌，訌亂},虹{彩虹，霓虹},蕻{雪裏蕻},葒,苰{藤苰},耾,翃,紘,紅{紅色},竑,硔,玒,洪,泓,弘,宏
hung6	hʊŋ22	哄{同鬨字，起哄；〈語〉圍攏，～住，圍着},鬨{起鬨，內鬨；〈語〉圍攏，～住，圍着},蕻{菜薹},澒
hyu1	hy55	吁{長吁短嘆，吁嘆},訏,虛,盱,歔,旴,墟{墟市},圩{同墟字},噓{吹噓}
hyu2	hy35	冔,詡,許,珝,栩,喣,咻{噢咻}
hyu3	hy33	去{來去},酗{酗酒},煦,昫
hyun1	hyn55	儇,𨟠,鋗,軒{(常)軒昂，軒轅},譞,諼,諠,蝖{蝖螜},萱,翾,禤,煖{同煊字},煊,烜,棬,暄,晅,嬛{便嬛},壎,塤,圈{圓圈},喧{喧譁，喧鬧},咺{顯著}
hyun2	hyn35	䘆{(語)黃～，蚯蚓},畎,甽{同畎字},犬,烜{(又)},暅{日氣},咺{兒啼不止}
hyun3	hyn33	券{(書)},綣,絢,楦{鞋楦},敻{營求},夐{營求},勸
hyut3	hyt3	吷,血
ik1	∅ek5	肊{(白)打～，打嗝}
jaa1	ja55	丫{(又)},𠭯{(白)},鴉{(又)},渣{(白)食～米，窩囊廢；水瓜～，瓜絡},摣{(白)},揸{(白)},抯{(白)},抓{(白)握、拿},喳{(白)吆～～，叫喳喳},呀{(又)},吖{(又)語氣詞},吔{語氣詞，哎～}
jaa2	ja35	吔{威～，英語wire}
jaa4	ja21	人{(語)～熊婆，傳說故事中裝扮成老太婆的熊，專吃小孩},喳{(語)吆～～，叫喳喳},呀{(又)表承接},吔{(又)表承接語氣}
jaa5	ja24	也{也是，也許}
jaa6	ja22	廿{(白)二十，二啊[a22]的合音，啊[a22]爲十的弱讀}
jaai2	jai35	跴{(白)},踹{(白)},踩{(白)}
jaai3	jai33	嘬{(白)嚼}
jaai4	jai21	人{(語)又音，～熊婆}
jaak1	jak5	吔{(又)語氣詞，哎～，表驚歎}
jaak3	jak3	吃{(白)},喫{(白)喫飯}
jaam3	jam33	滲{(語)又音},蘸{(白)又音}
jaang3	jaŋ33	撐{(白)蹬、踹}
jaap1	jap5	悒{(語)心～，心煩，本字不明}
jaap3	jap3	擪{(語)～火，惱怒},臿{(白)刺癢；粗～～，粗糙},眨{(白)眨眼},擫{(語)}
jaap6	jap2	熠{(白)閃爍}
jaau1	jau55	㕭{咿～，不認真，又作咿呦/咿嚘},抓{(白)搔、撓，俗字撓},呦{(語)咿～，不認真，又作咿㕭/咿嚘}
jaau2	jau35	爪{(白)}
jaau4	jau21	鷂{(又)}
jaau6	jau22	棹{(白)划，～手，招手},櫂{(白)划，～手，招手}
jai4	jɐi21	𠯋{壞的、差的，疑爲差/膗/𢶀的白讀}
jai5	jɐi24	跇{(白)孩童頑皮，又作跩字},跩{(白)孩童頑皮，本字跇}
jai6	jɐi22	勩{(又)},跩{同跇字},跇{踰也；跳也},枍,曳{搖曳，拖曳，曳引},拽{同抴/曳字，拖、牽引},抴{拖、牽引，後作拽}
jak1	jɐk5	吔{(又)語氣詞，哎～，表驚歎},簎{(白)刺}
jak6	jɐk2	掝{(語)又音，～手，招手；移～，不穩重}
jam1	jɐm55	吟{(白)笑～～，笑眯眯},𩬎{劉～，額前髮、劉海，本字蔭/陰},音,陰{陰天，光陰；〈語〉劉～，額前髮、劉海，又作蔭字},蔭{樹蔭，蔭翳；〈語〉劉～，額前髮、劉海，又作陰字},瘖,愔,喑
jam2	jɐm35	飲{飲酒；飲料}
jam3	jɐm33	廕{廕庇},飲{飲馬},蘸{(白)滲透、滲漏，俗字滲},蔭{蔭庇，蔭涼},窨{窨井},滲{(語)滲透、滲漏，本字蘸}
jam4	jɐm21	任{姓，俗讀責任之任},霪,簷{(白)},烎,淫,檐{(白)屋檐，瓦檐},崟,壬{壬子，六壬},吟{呻吟，吟詩},冘{冘冘}
jam5	jɐm24	荏,趛
jam6	jɐm22	任{責任；〈又〉姓，俗讀},餁,飪{熟也},賃{租賃},衽,腍{熟也},絍,紝{縫紝（口語用縫紉）},恁{這，那},妊
jan1	jɐn55	凐{寒貌},駰,闉,銦,諲,訢{同欣字；姓},茵,絪,禋,焮,炘,溵,湮{湮沒，湮滅},洇,氤,殷{殷勤；殷墟；姓},歅,欣{欣賞},昕,慇,忻,姻,堙,垔,因
jan2	jɐn35	㥯{謹也},隱,膶{粵字，禽畜的肝；擔～，扁擔；本字潤，避諱乾},潤{(白)禽畜的肝；擔～，扁擔；俗字膶},殷{雷聲},櫽,檃
jan3	jɐn33	印,鮣,釁{挑釁},衅,茚,舋{同釁字}
jan4	jɐn21	人{人民，工人},寅,夤,勻{(罕)},儿{同人字},仁{仁義；果仁}
jan5	jɐn24	允{(罕)},蚓,縯{引},癮,戭{長槍},忍,引,尹{(罕)},吲{吲哚},听{笑貌}
jan6	jɐn22	䏰,韌{堅韌},閏,軔,訒,胤,肕{堅肉；同韌字},紉,潤{滋潤，溼潤},憖{(又)},孕,刃,仞
jang3	jɐŋ33	韌{(語)肉食煮得不爛，韌硬的合音；～皮，頑皮}
jap1	jɐp5	㬤,邑,裛,翕{翕動，翕然},眨{(白)眨，～～眼},熻,熠{熠熠，熠耀},湆,浥{溼潤},泣{哭泣},揖{作揖，揖讓},挹,悒{悒鬱},執{(白)撮、抓},唈
jap6	jɐp2	入{入口，進入},込,擛{(白)揮動，～手；翅膀搧動聲}
jat1	jɐt5	一{一定，一個；～定中[tʃʊŋ33]，猜碼口令，數字一},辷,弌,壹
jat6	jɐt2	佚,馹,鎰{二十兩爲一鎰},逸{逃逸，安逸},軼,肸{肸蠁},溢{滿溢，溢出},昳{昳麗},日{日期，日頭（太陽）},佾
jau1	jɐu55	丘,麀,鵂,髹,邱,貅,蚯,茠{同休字},耰,搊{(白)拿、提},掫{(白)拿、提},憂,悠{(又)悠閒，又作優閒},庥,幽,咻{喧鬧},呦{呦呦},凪{(又)},優,优,休
jau2	jɐu35	友{(白)友崽（後起詞），後字調類化，視語境貶稱或暱稱},黝,鈾{(白)},釉{(白)釉面[min35]磚},蚴{蚴虬},柚{(白)蜜柚，沙田柚；囉～，屁股}
jau3	jɐu33	幼{年幼；〈語〉細，～沙},誘,蚴{毛蚴，尾蚴},皺{(白)},珛
jau4	jɐu21	冘{冘豫，同猶豫},鮋,魷,鞣,鈾,郵,遊{旅遊，遊戲},輶,輮,蹂,蝤{蜉蝤},蝣,蚰,蕕,莜{莜麥},繇{通由字},糅{糅合},粈{同糅字},疣,由,猷,猶,游{游泳，上游},浟{水流貌},油,柔,攸,揉,悠{悠久，悠閒},尤,尢{姓；同尤字},囮{(又)}
jau5	jɐu24	㞢{同有字},銪,酉,莠,羑,牖,槱,有,戭{長盾},友{朋友，老友},卣
jau6	jɐu22	佑,鼬{黃鼬},釉{彩釉},祐,狖,柚{(文)},宥,囿,右,又,侑
je1	jɛ55	爺{(白)伯爺公，伯爺婆}
je4	jɛ21	倻,鋣,邪{莫邪，琅邪；古同耶},耶{耶穌；同爺字；語助詞},琊,玡,爺{爺爺[jɛ35]，老爺；父也},椰,揶
je5	jɛ24	冶,野,若{般若},惹,嘢{東西，一說本字個，乜嘢即乜嘅（物個），另一說本字野/也/惹/若/如（上古魚部）},喏{唱喏}
je6	jɛ22	偌,射{僕射},夜
jek3	jɛk3	膱{(白)臭油～，油變質的氣味，即哈喇}
jem1	jɛm55	艷{(語)詞綴，紅～～},豔{(語)詞綴，紅～～}
jem4	jɛm21	艷{(語)詞綴，紅～～},豔{(語)詞綴，紅～～}
jen1	jɛn55	肕{(白)臉皮厚、死皮賴臉；丟臉、尷尬},齞{(白)咧嘴}
jeng4	jɛŋ21	贏{(白)輸贏}
jep3	jɛp3	擪{(白)～衫袖，捲起衣袖},擫{(白)同擪字}
jep6	jɛp2	擛{(白)又音，搧扇子聲}
jet1	jɛt5	逸{(白)用手撐起身體；躍過，～過}
jeu2	jɛu35	爪{(白)雞爪}
ji1	ji55	伊,𡄵,黟,銥,醫,譩,衣{衣服；衣錦還鄉，古讀去聲},蛜,繄,禕,猗{美盛貌；讚美},漪,洢,毉{同醫字},欹{同猗字，讚美},姨{(白)阿姨},噫,咿{咿唔，咿呀；～㕭，不認真，又作咿呦/咿嚘},兒{(白)乞～，乞丐，老派可作名詞後綴，相當於崽，貓～、雀～，又可作小稱，手指～噉大},依
ji2	ji35	倚{倚靠},齮,踦{抵住},綺,犄{去勢的公牛},椅,旖,掎{(又)},扆,婍,咦{(又)}
ji3	ji33	意,饐,鐿,議{(又)議論，倡議},薏,癔,瘞,殪,懿
ji4	ji21	儀{禮儀，儀式},鴯,鮞,飴{飴糖},頤,陑,鉹{(又)},酏,遺{(又)},迤{同迆字，逶迤},迆{逶迆},貽,誼{(又)},誃{門名；臺名},詒{贈送},觺{(又)},袲,螔,蛇{虛與委蛇},荑{莁荑；芟刈},胹,胰,耛,耏{頰鬚；地名用字},而,羠,簃,移,眙{盱眙},痍,疑{(又)},沂{沂河},椸,杝{椴木},扅,怡,彝,异{發歎詞},嶷{(又)},峏,宧,宜{(又)},姨{姨媽},夷,圯,咦,台{我也；同怡字},匜,兒{兒童，幼兒；～戲[hi55]，不可靠，又作兒嬉},儿{同兒字}
ji5	ji24	以,駬,餌,阤{阤靡},鉺,邇,迤{同迆字，迤邐},迆{迆邐},議{會議，議論，倡議},苡,耳,矣,珥,爾{偶爾},洱{普洱，洱海},已,尔,佁{癡；靜}
ji6	ji22	二{第二，二十；～氣來、～氣（諧音義氣），猜碼口令，數字二},髶{髮飾},食{古人名，酈食其},貳{貳心，貳臣},誼{(又)},肄{肄業},義{義氣，意義},異{差異，異常},潩,易{容易},弍,异{舉也；同異字},廙,咡,勩{勞也},劓,儀{(常)讀聲符義},佴{次、隨後},伿
jik1	jek5	億,螠{縊女},臆,膉,肊{氣滿},繶,益,抑,憶,嗌{咽喉}
jik6	jek2	㑊,驛,釴,譯,蜴,腋{腋窩},翼,翌,翊,繹,睪{伺視},疫,燚,熤,液,杙,易{交易},掖,懌,役,弋,弈,嶧,射{無射},奕,埸,域{(又)},亦{亦有，亦可},䭞{飯壞}
jim1	jim55	㤿{～憸，愛挑剔},閹,醃{(書)},腌{(書)},淹,懨,崦,奄{奄奄一息}
jim2	jim35	㜝{美},𥀬{痂},龑,黶,魘,罨,演{(習)表演，演員},渰,掩,弇{蓋也},奄{奄有，奄忽},厴{蟹腹下甲；螺殼口圓片蓋}
jim3	jim33	俺,饜,覎,厭
jim4	jim21	儼{(常)儼然，讀同嚴},鹽{食鹽；醃},髯,阽{(又)},閻,閆{姓},蚺{(又)},芫{(習)芫荽，又作芫茜/鹽西},簷{同檐字},炎,檐{屋檐，瓦檐；～蛇，壁虎},嫌{嫌棄，涉嫌},嚴,呥
jim5	jim24	䎃,苒,礹{險峻},琰,棪,染,扊,广{因巖爲屋},剡{銳利，削尖},冉,儼{儼然}
jim6	jim22	掞{照耀},釅{釅茶},豔{鮮豔，豔麗},艷{同豔字},爓{同焰字},燄,焱,焰{火焰，焰火},灩{瀲灩}
jin1	jin55	咽{咽喉},閼{閼氏},鄢,蔫{(語)～韌[ŋɐn22]，食物有勁道，俗字煙韌},菸{香菸，菸草；燒～，抽菸},臙,胭,燕{燕京、姓，俗讀燕子之燕},煙{煙霧，冒煙},焉{焉能，焉知；〈又〉心不在焉，俗讀},漹,湮{(常)湮沒，湮滅},殷{殷紅},巘{(白)崖[ŋa21]～，危險，俗作牙煙/崖广，另一說危險音變},嫣
jin2	jin35	偃,鼴,鶠,郾,躽,衍{敷衍，衍生},蝘,縯{長},燕{(白)踢～，踢毽子},演{(書)},毽{(習)踢毽，本字燕},戭{人名用字}
jin3	jin33	咽{吞咽},鷰{同燕字},豔{(常)俗讀},諺{(又)},艷{(常)俗讀},燕{燕子},灩{(又)},彥{(又)},宴,嬿,墕{地名用字；同堰字},堰,嚥{吞嚥}
jin4	jin21	㘋,賢,言,蜒,舷,臤{同賢字},綖,絃{琴絃},筵,硏,研{研究，鑽研},痃,玹{姓},燃,然,焉{心不在焉，俗讀焉能之焉},涎{垂涎},揅,弦{弓弦},延,妍,埏{邊際},伭,㳄
jin5	jin24	俔{譬喻},睍{小目貌},甗,沇,巘{峭巘，巘崎},兗
jin6	jin22	唁,𪗛{同齞字},齴{同齞字},齞{露齒貌},讞,諺,見{同現字},蜆{蝶類的幼蟲；〈語〉～蟲，蚜蟲},莧{莧菜},硯{硯臺，墨硯},現,烻{光熾},晛,彥,峴
jing1	jeŋ55	嚶,鸚{鸚鵡},鷹{老鷹（口語用崖[ŋa21]鷹，俗作牙鷹）},鶯{(又)},鍈{(又)},鉠{(又)},蠅{(白)蚊蠅，烏蠅，蒼蠅},蘡,英,膺,纓,瓔,瑛,櫻{櫻桃},攖,扔{(白)},應{應當，應該},嬰,媖
jing2	jeŋ35	影{影響，電影；～相，照相},穎{(又)},癭,潁{(又)},映{反映，放映}
jing3	jeŋ33	應{答應，應用}
jing4	jeŋ21	仍{仍然，仍舊},陘{井陘},鎣,鉶,鈃{古酒器},邢,迎{迎接，歡迎，與逆對轉},贏{(文)},蠅{(文)蠅頭小利，蠅營狗苟},螢,艿{舊草未割新草又生},縈,硎,盈,瑩,營{經營，營養},熒,瀠,瀛,瀅,濚,滎{滎陽；滎經},楹,扔{扔掉},形,嬴,娙,塋,型,刑
jing5	jeŋ24	郢
jing6	jeŋ22	媵,認
jip3	jip3	擪{(文)},靨{酒靨},醃{(習)醃肉，醃製},腌{(習)同醃字},擫{(文)}
jip6	jip2	䈎,饁,頁,葉{樹葉；古邑名、姓，古讀書涉切},燁,楪{窗牖},曄,擛{動貌},擖{箕舌},揲{箕舌}
jit3	jit3	䊦,黦{色壞也},謁,蠮{蠮螉},噎{噎住},咽{哽咽},乙{(又)}
jit6	jit2	抴{(又)},熱,拽{(又)拖、牽引}
jiu1	jiu55	㙘,邀,要{要求；姓},腰,徼{同邀字},幺{幺二三},妖,夭,喓,吆{吆喝},么{同幺字}
jiu2	jiu35	扰,繞{圍繞；繞線},窈{(又)本讀},窅,杳{(又)本讀},擾
jiu3	jiu33	要{重要}
jiu4	jiu21	僥{僬僥},鰩,饒,颻,陶{古人名，皋陶},銚{大鋤；姓},遙,軺,謠,蟯,蕘,繇{通徭/謠字},窯,瑤,珧,猺,洮{湖名},橈{船槳},搖,徭,嶢,嬈,媱,姚,堯,垚
jiu5	jiu24	崾,舀{舀水}
jiu6	jiu22	曜,鷂{鷂鷹，紙鷂},耀,燿
jo1	jɔ55	唷{嘆詞},喲{嘆詞}
jo2	jɔ35	唷{(語)表驚訝},喲{(語)表驚訝}
joek3	jœk3	約{約定，預約；用秤稱},躍{跳躍，躍進},葯{白芷}
joek6	jœk2	叒,龠,鰯,鑰{鑰匙},鄀,謔{(又)},虐{(又)},藥{草藥，藥片},蒻,葯{同藥字},若{若是},籥,箬,瘧{(又)},爚,瀹,櫟{櫟陽},弱,婼{婼羌}
joeng1	jœŋ55	咉,鴦{鴛鴦},鞅{馬頸革；鞅掌；商鞅},陽{姓},鍈{同鉠字},鉠{鈴聲},秧,泱{泱泱；植物的漿，樹～，樹漿，木瓜～，木瓜漿},殃,央
joeng2	jœŋ35	怏,鞅{牛鞅；鞅鞅},樣{(白)模樣，樣子，點樣（怎樣）},抰
joeng4	jœŋ21	䉴{䉴䉛},鬤{頭髮亂貌},颺,陽{太陽},鍚,蛘{米象},蘘,羊,穰{禾莖；同瓤字},禳,瘍{潰瘍},痒{病也},瑒{玉名；花名},煬,烊{熔化；打烊},瀼{露多貌},洋,楊,暘,揚{揚手，宣揚},徉,垟,儴{因循，沿襲},佯
joeng5	jœŋ24	䑋,養{養育；供養，古讀去聲},蛘{通癢字},癢{撓癢，瘙癢},痒{同癢字},氧,卬{同仰字},仰{信仰}
joeng6	jœŋ22	䭐{餌也；將肉餡兒塞入豆腐、苦瓜、豇豆等菜裏蒸煮成菜肴，～豆腐、～苦瓜，俗字釀},釀{釀酒，醞釀},讓,羕,瀼{水名在蜀},漾,樣{樣板，一樣，樣貌},攘{攘外安內，擾攘},恙,壤{土壤},嚷
jot1	jɔt5	黦{(語)腐爛；頹敗；能力差}
ju2	ju35	唷{(語)哎[ui35]～，表驚訝}
jui1	jui55	椎{(白)},錐{(白)鐵錐；鑽、刺}
jui2	jui35	嘴{(白)～一啖，咬一口}
jui4	jui21	緌,蕤
jui5	jui24	蕊,鋭{(又)},銳{(又)},蘂{同蕊字}
jui6	jui22	枘,鋭,銳{尖銳，銳利},裔,蜹,蚋,芮{姓},睿,汭
juk1	jʊk5	勖,頊,隩{河岸彎曲處},鋈,郁{馥郁；姓},逳{行；〈語〉動，演變類同育字，俗字喐},薁,育{教育，體育},燠{熱},煜,沃,毓,昱,旭,彧,喐{動，聲母演變同育字，本字逳},勗{同勖字}
juk6	jʊk2	堉,鵒,鬻{鬻文，賣官鬻爵},鈺,辱,谷{吐谷渾},褥,蓐,肉,縟,硲,玉{玉石，白玉},獄,溽,淯,浴,欲{意欲，將欲，欲言又止},慾{慾望，貪慾},峪
jung1	jʊŋ55	㙲{同壅字},鶲,髶{(白)毛髮、絲、線等蓬亂},饔,雝{雝渠，雝雝；同雍字},雍{雍和，雍容},鎓,邕{邕州，邕江，邕劇},螉{蠮螉},臃,翁{老翁},癰,澭,滃{滃江},擁{(又)擁軍；路名，雙擁路},壅{壅塞},噰,嗡{嗡嗡},嗈
jung2	jʊŋ35	佣{(白)佣金，佣錢},𣭲{(又)},鯒,踴{同踊字},踊{踊躍},蛹{蠶蛹},蓊,羢{(白)},絨{(白)絨布，燈芯絨},甬{甬道},滃{雲氣起；大水貌},湧{同涌字},涌{涌現，泉涌},氄{(又)},擁{擁有，擁護},恿,宂{(又)},埇,冗{(又)},俑
jung4	jʊŋ21	傭{傭工，僱傭},𣭲{𣭲毛},鱅,鰫,髶{髮亂},顒,鏞,鎔{鑄器模型；鎔鑄；鎔化},鄘,蠑,融,蓉,茸{鹿茸，蒜茸，毛茸茸；〈語〉～～爛爛，稀爛},肜,羢,絨{絨毛，絲絨},瑢,狨,熔{熔化},熊,溶,氄{氄毛},榮{光榮，榮幸},榕,搑{擣也},戎,慵,庸,嶸,容,宂{宂長，撥宂},墉,喁{魚口向上},冗{同宂字，冗長，撥冗}
jung5	jʊŋ24	勇
jung6	jʊŋ22	㶲,用,佣{(文)}
jyu1	jy55	于{同於字},迂,込{(又)},紆,淤{淤泥，淤積},於{於是，終於；姓},吁{(又)}
jyu2	jy35	傴,瘀{瘀血，瘀傷；（菜等）受擠壓而損傷},嫗,噢{噢咻}
jyu3	jy33	燠{燠休},飫
jyu4	jy21	予{我},魚,髃,餘{剩餘},顬,雩,隅,隃,銣,邘,逾{逾期，逾越；逾甚},輿,踰{同逾字，踰越，踰矩},諛,覦,襦,褕,蠕,蝓,虞,薷,萸,茹,艅,舁{擡},臾,臑{嫩軟貌},腴,竽,窬,禺,盂,畬{新田二歲},璵,瑜,狳,牏,濡,漁,渝,毹,歟,歈,榆,旟,揄,挐{牽引},愚,愉,庾{(又)},嵛,嵎,崳,孺,嬬,娛,妤,如,嚅,喁{應和聲},儒,俞,余{我也；姓},于{之子于歸；單于；姓；俗讀於是之於}
jyu5	jy24	㺄,齬,雨,鋙{鉏鋙},鄅,貐,語{語言},與{贈與；參與，古讀去聲},羽,窳,禹,瘐,瑀,汝,敔{柷敔},擩{染；插},庾,嶼{(常)島嶼，讀同與},峿{岨峿},宇,圉,圄,俁,予{賦予},乳,与{同與字}
jyu6	jy22	喻,馭,預,遇,豫,譽{榮譽},諭,語{告訴，不以語人},裕,蕷,籲{呼籲},禦,癒{癒合},瘉,玉{(語)玉米，本字御米},澦,洳,愉{(又)},愈{愈加},悆,御,峪{(又)},寓
jyun1	jyn55	㾓{骨節痠痛},鵷,鴛{鴛鴦，鴛侶},鳶,蜿{蜿蜒},蜎{蜎蜎},葾{食物不鮮},箢{箢箕},眢,渕,淵,涴{地名，涴市（在湖北）},宛{古地名，大宛},冤
jyun2	jyn35	䩩,願{(白)情願，寧願（口語用能願，能字古有寧可義）},院,菀{紫菀},苑,膶{(老派)},縣{(白)武鳴縣，邕寧縣，橫縣},畹,琬,潤{(白)禽畜的肝；擔～，扁擔；俗字膶，避諱乾},涴{涴演},夗
jyun3	jyn33	怨,惌
jyun4	jyn21	䮄,黿,騵,鉛,鈆,轅,袁,螈,芫{(書)},芄,羱,緣,紈,眩{(常)讀聲符玄},盷,痃{(又)},玹{玉色；石次玉},玄,猿,爰,烷,炫{(常)讀聲符玄},源,湲,沿,沅,櫞,椽{(又)讀同緣},杬,援{援救},懸,完,嫄,媛{名媛，嬋媛},妧{人名用字},塬,堧,圜{天體；同圓字},圓,園,員{人員，員外},原,刓,元,伭{(又)},丸{肉丸}
jyun5	jyn24	媆,阮,鉉,遠{遙遠；敬而遠之，古讀去聲},軟,薳{植物嫩莖},瓀,泫,朊{蛋白質}
jyun6	jyn22	䏰{(老派)},願{願望，願意},閏{(老派)},衒,縣{縣城，縣份},眩{眩暈，目眩},瑗,琄,玹{玉名},炫{炫耀，炫目},潤{(老派)},昡,掾,愿,孕{(老派)},媛{美女},垸
jyut3	jyt3	乙{甲乙},黦{黃黑色},釔
jyut6	jyt2	刖,閲,閱,鉞,鈅,軏,越,説{通悅字},說{通悅字},茓,粵,穴,玥,爇,樾,月{月亮，月份},曰,抈,悦{同悅字},悅{愉悅，悅目},噦{嘔吐}
kaa1	kʰa55	佧{佧佤族},胩,旮{(語)又音，～旯[la55]頭，苤藍或苤藍的莖},揢{掐},拤{掐，本字揢},抲{同揢字},峠,家{(又)而～，現在},喀{喀嚓},咖{咖啡},咔{象聲詞；音譯用字，咔嘰，咔唑},卡{關卡，卡片，卡通}
kaa3	kʰa33	㰤{張口息；大笑},髂,駕{(白)駕駛，駕馭},架{(白)衣架；量詞，一架},旮{山旮旯},假{(白)放假}
kaa4	kʰa21	咔{(語)阻塞，～頸，卡頸}
kaai2	kʰai35	楷{楷書},鍇,蒈
kaai3	kʰai33	炌
kaak3	kʰak3	咯{同喀字，咯痰，咯血},緙{緙絲},喀{喀痰，喀血}
kaam1	kʰam55	勘{(又)}
kaam2	kʰam35	坎{(又)坎坷，心坎},砍{(又)},檻{門檻，又作門坎}
kaat3	kʰat3	擖{刮；撻}
kaau3	kʰau33	㸆,鮳,靠,銬,犒{犒勞},校{(又)學校}
kai1	kʰɐi55	傒{(白)傒倖},鼷{(白)},鸂,騱{(白)},蹊{(白)蹊蹺；蹊徑},谿{勃谿；姓；同溪字},稽{稽查，滑稽},磎,溪,徯{(白)},嵇{(白)},奚{(白)奚落；姓},剋{(語)打、罵，捱～，官話借詞}
kai2	kʰɐi35	呇{明亮的星},綮{戟支；戟衣},稽{稽首},棨,啟{同啓字},啓{啓發，啓動}
kai3	kʰɐi33	契{契約},蟿,碶,瘛{(又)}
kak1	kʰɐk5	㩿{(語)㪐～，路不平或說話結巴，本字犖確，與掕掯（硠砊）對轉},確{(白)犖[lɐk5]～，路不平或說話結巴，俗字㪐㩿，與掕掯（硠砊）對轉},氪{(白)},喀{(語)瘦嚜[mɐk5]～，很瘦，與躿對轉},剋{(白)剋扣，相剋，剋星},刻{(白)時刻；用刀刻},克{(白)一克，攻克，多用於量詞或克服義}
kam1	kʰɐm55	禁{弱不禁風；耐久，耐受},襟{襟懷，衣襟，連襟（口語用老襟）},衿,衾
kam2	kʰɐm35	冚{蓋，本字𠖫，與扱/䆟對轉},𠖫{蓋，與扱/䆟對轉，俗字冚},扻{(白)摑}
kam4	kʰɐm21	噙,黚{(白)黃～～，深黃色；藍～～，深藍色},蠄{蟲名；〈語〉～螺，蜘蛛，～蟝，蟾蜍},芩,禽,琹,琴,涔{(又)},檎,梣{(又)},擒,扲{同擒字},岑{(又)地名，岑溪，讀同芩}
kam5	kʰɐm24	妗{～母[mu35]，舅母，～婆，舅奶奶，本爲舅母受後字逆同化而來}
kan4	kʰɐn21	勤,芹,懃,慬,廑{通勤字}
kan5	kʰɐn24	䐃{(白)禽類的胃（百姓以爲禽的腎），俗字肫},近{(白)附近，行近},肫{(語)禽類的胃（百姓以爲禽的腎），本字䐃}
kang1	kʰɐŋ55	躿{(語)瘦蜢[mɐŋ55]～，瘦貌，與喀對轉},鏗{(白)鏗鏘}
kang2	kʰɐŋ35	哽{(白)骨～在喉，又作鯁/骾字},鯁{(白)骨～在喉，又作哽/骾字},骾{(白)骨～在喉，又作鯁/哽字},啃{(白)啃爛，本字齦，本音墾}
kang3	kʰɐŋ33	掯{強取也；〈語〉（菸、酒）勁大，（人）高傲，本字炕，乾也；半掕[lɐŋ33]～，半途、半路，本字硠砊，與㪐㩿（犖確）對轉},裉,砊{(白)半硠[lɐŋ33]～，半途、半路，俗字掕掯，與㪐㩿（犖確）對轉},炕{(白)（菸、酒）勁大，～喉，嗆喉，（人）高傲，～抖，目中無人，俗字掯}
kap1	kʰɐp5	㝓{(白)},給{供給，給予},級,笈{祕笈},汲,歙{同吸字},扱{收斂；〈語〉蓋，本字䆟},噏{同吸字},吸,伋,䆟{(白)蓋，與冚/𠖫對轉，俗字扱},㴔
kat1	kʰɐt5	咳{咳嗽},欬{咳嗽}
kau1	kʰɐu55	勼{(語)摻雜、混合，一說本字勾},芤,瞘{眼瞘},牞{(又)},摳{挖，～牆壁；擡起、端起，～張凳來},彄
kau3	kʰɐu33	䍍,釦{鈕釦},購{(白)購買},覯{(白)},蔻,筘,灸{(白)鍼灸},構{(白)結構},构{(白)},扣{扣住},寇,媾{(白)},叩{叩頭},佝{佝瞀}
kau4	kʰɐu21	㞗,鼽,銶,釚,釓{同釚字},逑,賕,訄,裘,虯,莍,艽{遠荒},璆,球,犰,求,巰,俅,仇{姓，俗讀仇敵之仇}
kau5	kʰɐu24	桕,舅,臼
ke1	kʰɛ55	屎{(語)屎，曉母讀如溪母，俗字𡲢},𡲢{屎，本字屎，曉母讀如溪母},茄{(外)茄哩啡，龍套、小角色，英語carefree}
ke2	kʰɛ35	茄{(白)茄汁}
ke4	kʰɛ21	伽{伽藍},騎{騎馬，騎兵},茄{番茄，茄子，茄瓜},癿,奇{(白)～離[lɛ21]，古怪}
kek1	kʰɛk5	喀{(語)瘦嚜[mɛk5]～，很瘦，與躿對轉},屐{(白)木屐}
kek6	kʰɛk2	乪,屐{(文)},劇{劇烈；戲劇}
kem4	kʰɛm21	箝{(白)},鉗{(白)老虎鉗，蟛鉗（小河蟹）；〈語〉象聲詞，咳～～，不停地咳嗽}
kem5	kʰɛm24	芡{(白)打～，勾芡},魽{(白)魽魚，本字不明}
ken2	kʰɛn35	掐{(語)掐、卡，～頸，本字揵},揵{(白)掐、卡，～頸}
keng2	kʰɛŋ35	躿{(語)瘦蜢[mɛŋ35]～，瘦貌，與喀對轉}
keng4	kʰɛŋ21	擎{(白)靈[lɛŋ21]～，靈驗，靈的分音}
ket1	kʰɛt5	橛{(語)量詞，截}
keu1	kʰɛu55	橇{(白)雪橇},蹻{(白)同蹺字},蹺{(白)蹺腳},翹{(白)翹腳（翹二郎腿），翹手（抄着手）；乾～～，乾貌},繑{(白)}
keu2	kʰɛu35	巧{(罕)}
keu3	kʰɛu33	撬{亂翻}
keu4	kʰɛu21	翹{(語)～翹[kʰɛu55]，死亡}
ki1	kʰi55	崎{崎嶇},踦{腳跛},觭{角一俯一仰},畸,欹{同攲字，傾斜},榿{(又)},攲{傾斜}
ki2	kʰi35	企{(語)屋～，家裏},婍{(又)}
ki3	kʰi33	亟{亟請}
ki4	kʰi21	䓫,𨙸,麒,鰭,鯕,鬾{小兒鬼},騏,頎,隑{同碕字},錡,軝,跂{足多趾},衹{衹衼},蟣{水蛭},蜞,蘄,萁{豆萁},芪,耆,綦{綦巾；姓},祺,祈,祇{神祇},祁,碕,碁,琪,琦,淇,歧,棋,棊,期{日期},旗,旂,愭,忯{忯忯；敬也},崎{地名，長崎（在日本）},岐,奇{奇怪},埼,圻{地的邊界；姓},凧{(又)},其{其他},俟{万俟，複姓},伎{伎伎},亓
ki5	kʰi24	企{企業，企求},跂{踮起腳跟},徛{站立；～理，整齊、整潔}
kik1	kʰek5	隙{(常)縫隙，空隙},𠽤{象聲詞，～嚦[lek5]緙[kʷʰɐk5]嘞[lɐk5]，各種事物}
kim4	kʰim21	扲{基業},黚{淺黃黑色},黔{黔首，黔驢技窮},鉗{(文)},鉆{同鉗字},鈐,箝{(文)}
kim5	kʰim24	魽{(文)}
kin2	kʰin35	搴{(白)揭開，與揭對轉}
kin4	kʰin21	乾{乾坤，乾隆},虔,犍{(又)犍爲縣},揵{舉也},掮,墘
king1	kʰeŋ55	傾{傾盡，傾斜；〈語〉聊}
king2	kʰeŋ35	廎,頃{頃刻，公頃},苘{苘麻},檾{檾麻}
king4	kʰeŋ21	凝{(語)（豬油等）凝結},黥,鯨,瞏,瓊,璚{同瓊字},煢,澄{(語)澄清（水、液體）},檠,擏{同擎/檠字},擎{引擎，擎天柱},嬛{美好；同煢字},勍
kit3	kʰit3	劼,𢷒,黠{(又)狡黠俗作狡詰},頡,鍥{鍥而不捨},詰{詰問},訐,襭,蠍{(白)蠍子，蛇蠍},蝎{(白)同蠍字},蛣{蛣蜣},羯,纈{採纈},絜{度量},竭{竭力，枯竭},碣,擷,揭{揭開，與掀/搴對轉},挈{提綱挈領，帶挈},孑,契{契闊；契丹}
kiu2	kʰiu35	巧{(白)巧妙，啱巧（湊巧），七巧（猜碼口令，數字七）},蹺{蹊蹺，又作蹊蹻}
kiu3	kʰiu33	竅
kiu4	kʰiu21	僑,鞽,趫,蕎,翹{銀翹，翹首},礄,橋,嶠{山尖而高},喬{喬木；姓}
kiu5	kʰiu24	皛,藠{藠頭}
ko1	kʰɔ55	柯,軻,蝌{(白)蝌蚪},苛,稞,珂,牁,樖{樹枝交連},棵{一棵}
ko2	kʰɔ35	顆{一顆，顆粒}
ko3	kʰɔ33	課{(白)上課},騍{(白)}
ko4	kʰɔ21	閜{(語)～寥[lɛu55]翹[kʰɛu55]，彎曲、捲曲，又作閜料峭}
koek3	kʰœk3	卻,醵{(又)},覺{(常)感覺，覺得},臄,噱{大笑；噱頭，俗作謔頭，曉母讀如溪母}
koeng1	kʰœŋ55	僵{(白)凍僵},韁{(白)同繮字},蜣,腔{(又)腔調，讀同羌},羌,繮{(白)繮繩，脫繮},疆{(白)新疆，邊疆，疆域},畺{(白)},殭{(白)殭屍},彊{(白)同疆字}
koeng2	kʰœŋ35	強{(又)勉強；倔強},鏹{(又)},彊{(又)同強字}
koeng4	kʰœŋ21	強{強大},蔃{蔃莍},彊{同強字}
koeng5	kʰœŋ24	弶,鏹{鏹水，白鏹},襁{襁褓},膙,羥{羥基},繈,彊{同強字},強{勉強；倔強}
koi2	kʰɔi35	凱{(白)},闓{(白)},鎧{(白)},愷{(白)},塏{(白)},剴{(白)}
koi3	kʰɔi33	丐{乞丐，丐幫},鈣{鈣化，補鈣},溉,概,摡{洗滌；主也},戤,慨{慷慨，感慨},愾,嘅{同慨字}
kok1	kʰɔk5	噱{(語)詞綴，笑～～，笑哈哈}
kok3	kʰɔk3	㸌,𦞦,霍,钁{大鋤},郭,觳{瘠薄},覺{(白)感覺，覺得},蠼{母猴},藿{藿香},臛,礐,磕{(語)～頭，本字硞},碻,確{的確，確定},确,硞{石聲；堅固；〈語〉～頭，磕頭},矐,矍{矍鑠},玃,漷,涸,毃{(又)},槨,榷{商榷},曤,攫,攉,擴{(又)},擱{(白)擱腳，耽擱},搉{敲擊；通榷字},愨,恪,彍{同彉字},彉{張也},廓{輪廓，廓清},崞,壑,埆,劐{裂也},㺢
kong1	kʰɔŋ55	匡{(文)},軭{(文)},誆{(文)},筐{(文)},眶{(文)},洭{(文)},框{(文)},慷{(白)慷慨},哐{(文)}
kong3	kʰɔŋ33	亢{亢奮},閌{閌閬},鈧,鄺,貺,纊{絲綿絮},穬{芒粟},礦,砊{石聲},獷{(又)},爌,炕{火炕，炕頭},況,曠{空曠，曠野},擴{擴充，擴大},抗,夼,壙,囥{藏也},伉
kong4	kʰɔŋ21	俇{俇攘},鵟,誑,狂,扛{扛起，扛槍；馬螂～，螳螂}
ku1	kʰu55	圐,骷{(白)骷髏},箍,枯{(白)乾枯，枯萎}
ku4	kʰu21	瓠{(語)瓠蘆，即葫蘆；瓠瓜},葫{(又)葫蘆，又作瓠字}
kuk1	kʰʊk5	嗑{(語)又音，～瓜子，本字硞},𪨰,麴{酒麴；姓},麯{同麴字},酷{(又)},蛐,硞{碌硞；〈語〉又音，～瓜子，嗑瓜子，咬～～，咬硬物貌},焅{(又)},曲{曲折；歌曲；姓}
kung1	kʰʊŋ55	碽{(語)響～～，咚咚響}
kung2	kʰʊŋ35	孔{(又)},鞏{(又)},恐{(又)}
kung3	kʰʊŋ33	控{(又)}
kung4	kʰʊŋ21	穹,銎,邛,跫,蛩,藭,筇,窮
kwaa1	kʷʰa55	侉{疲憊；同夸字},骻{同胯字},跨{跨越，讀同誇/夸},誇{誇獎，浮誇},胯{胯部，胯骨，讀同誇/夸},姱,夸{奢侈；夸克},垮{垮臺，打垮}
kwaa2	kʷʰa35	侉{粗笨；口音不正},垮{(又)打垮}
kwaa3	kʷʰa33	挎{挎包}
kwaai2	kʷʰai35	拐{(又)拐棍},蒯{蒯草；姓},柺{(又)},枴{(又)}
kwaai5	kʷʰai24	㨤{同擓字},擓{舀，～水，又作㨤字}
kwaak3	kʷʰak3	𡃈{框、圈，與框/纊對轉，一說本字廓，上古鐸部}
kwaang1	kʷʰaŋ55	㝩{(白)空～㝗，空蕩蕩},軭{(白)},誆{(白)},筐{(白)},眶{(白)眼眶},洭{(白)},框{(白)門框；框住，與𡃈/廓對轉},哐{(白)象聲詞，傾鈴[leŋ55]～啷[laŋ55]，器皿碰撞聲},匡{(白)}
kwaang2	kʷʰaŋ35	梗{(白)菜梗，豆梗}
kwaang3	kʷʰaŋ33	摜{(語)扔、丟，疑本字曠，廢也，上古陽部}
kwaat3	kʷʰat3	括{(又)}
kwai1	kʷʰɐi55	嶲{同巂字},鬹,闚{同窺字},規,虧,窺,盔{頭盔，盔甲},櫆{(又)},巋,巂{子巂}
kwai2	kʷʰɐi35	傀{傀儡},頍,跬,煃
kwai3	kʷʰɐi33	儈,鱠,鄶,膾{膾炙人口},聵,硊{石硊},獪{狡獪},澮,潰{潰膿，崩潰},檜{喬木名；秦檜},憒,愧,媿{同愧字},嘳,劊{劊子手}
kwai4	kʷʰɐi21	㙓,魁,騤,馗,隗{姓},酅,逵,觿,蠵,蝰,葵,睽,眭{目深惡視},癸{(常)壬癸，讀同葵},畦{菜畦},櫆,暌,攜,戣,奎,夔,喹
kwai5	kʷʰɐi24	揆
kwak1	kʷʰɐk5	嗑{(語)～瓜子，本字硞},钁{(白)钁頭},鐝{(語)鐝頭},緙{(語)象聲詞，𠽤[kʰek5]嚦[lek5]～嘞[lɐk5]，各種事物},硞{(語)～瓜子，嗑瓜子},搉{(白)斫；劃（火柴）；敲}
kwan1	kʷʰɐn55	囷,鵾{(白)},鯤,髡,錕,鋆{人名用字},鈞{(白)千鈞，舊讀},醌,琨,焜,昆{昆蟲，昆明},崑{崑崙山},婫{人名用字},堃,坤,均{(白)平均，均勻，舊讀}
kwan2	kʷʰɐn35	壼,鯀{(又)},閫,輥{(又)},緄{(白)緄邊},綑{同捆字},混{(語)～社會，～到一起},捆{捆綁},捃,悃
kwan3	kʷʰɐn33	困{困難},窘{窘迫},睏{(文)}
kwan4	kʷʰɐn21	宭,麇{成羣},裙,群{同羣字},羣{群體，一羣人}
kwan5	kʷʰɐn24	䐃{腸中脂},菌
kwang1	kʷʰɐŋ55	轟{(白)轟炸，轟動}
kwang3	kʷʰɐŋ33	纊{(語)掛着、絆着，與𡃈對轉}
kwe2	kʷʰɛ35	𧊅{(白)小青蛙，本字或爲蛙，上古支部}
kwe3	kʷʰɛ33	㨤{(白)撥拉},擓{(白)撥拉}
kwe4	kʷʰɛ21	瘸{瘸腿},蟝{(語)蠄～，蟾蜍，俗字瘸}
kwik1	kʷʰek5	掝{破裂聲},隙{縫隙，空隙},郤{古地名；通隙字；姓},郄
kyu1	kʰy55	㘗,鮈,驅,駒{(白)},軀,跔,袪,胠,祛,痀{(又)},泃{水名},樞{(又)},敺,拘,嶇{崎嶇},區{區域},佝{同拘字},佉,㭕
kyu4	kʰy21	劬,鼩,鴝,軥{軛下曲者},衢,蠼{蠼螋},蠷,蟝{蛆蟝；〈語〉蠄蟝（蟾蜍）},蘧,蕖,磲,瞿{姓},癯,璩{耳環；玉名；姓},灈,渠{水渠，渠道},氍,朐
kyu5	kʰy24	佢{他，本字渠，代詞（你我）調類化，語流中易讀齊齒陰去},𠍲{同渠字，他},距{距離，差距},竘,渠{(白)他，俗字佢，代詞（你我）調類化，語流中易讀齊齒陰去},拒,岠{(又)}
kyun4	kʰyn21	婘{美好貌},鬈,顴{顴骨},踡,觠,蜷,權,拳
kyut3	kʰyt3	㵐,鴃,駃{駃騠},闕{宮闕；失也},闋,鐝,鐍,蹶{一蹶不振，尥蹶子},譎,訣,觖,蕨{蕨菜},缺{缺乏，短缺},砄,璚{同玦字},玦,獗,炔{乙炔},決,橛{木橛，又作橜字},撅{翹起；折斷},抉,憠{脾氣憠},孓,噘{噘嘴},厥,劂
la3	lɐ33	嘞{(語)語氣詞，弱讀}
laa1	la55	剌{割開；音譯用字},鞡,砬{(又)},旯{(語)旮[ka55/kʰa55]～頭，苤藍或苤藍的莖},喇{喇叭；象聲詞},啦{助詞；啦啦隊}
laa2	la35	喇{喇嘛},辣{(語)～利，舌頭受到刺激；老～，內行、老手},揦{抓，攬}
laa3	la33	喇{語氣詞，弱讀爲嘞[lɐ33/lə33]或啊[∅a33/∅ə33]},罅{縫隙},旯{山旮旯},嚹,嘞{語氣詞，同喇字}
laa4	la21	啦{(語)走～～，四處奔走；～～臨，迅速}
laa5	la24	藞{藞䕢}
laai1	lai55	孻{粵字，排行最小的，一說本字落，本地用晚},拉{拉扯，拖拉}
laai2	lai35	瀨{(語)～嘢，中招、遇到麻煩，本字不明},𦧺{舔，一說舐字音變，本地不用}
laai3	lai33	哂{(語)又音，語流音變},賴{(又)～臭，耍賴，後字調類化},癩{癩瘡，癩蛤蟆；〈又〉癩痢},嗮{(語)嗮的語流音變}
laai5	lai24	攋{(白)～尿，遺尿，俗字瀨/落},襰{衣破貌}
laai6	lai22	攋{毁裂；〈又〉～尿，遺尿},賴{依賴；姓；～臭，耍賴},籟,瀨{急瀨，湍瀨}
laak1	lak5	嘞{(語)～咑[tak5]，不整潔}
laak3	lak3	嘞{（衣服）裂開},肋{(又)打赤[tʃʰi33]～，打赤膊}
laak6	lak2	砳
laam1	lam55	籃{(白)菜籃（特指）}
laam2	lam35	擥,𥗽,覽,罱,灠{灠柿子},漤{漤柿子},欖{橄欖；喉～，喉結},攬{攬住；包攬，與拉/擸對轉}
laam4	lam21	婪,襤,藍,籃{花籃，籃球，菜籃（泛指）},嵐
laam6	lam22	檻{欄杆；獸檻},艦,纜,灠{同濫字},濫{氾濫，濫用；～賭，～哭，～飲}
laan1	lan55	欄{(白)豬欄},躝{(白)爬行；滾開},蘭{(白)荷蘭，蘭豆；〈外〉女友的俗稱，英語friend（法蘭）引申而來}
laan4	lan21	攔,闌,鑭,躝{(文)踰也},讕,襴,蘭{蘭花，玉蘭},瀾,欄{圍欄},暕{陰乾},斕
laan5	lan24	嬾,懶
laan6	lan22	濫{(又)俗讀，～賭，～哭，～飲，俗字爛},爛
laang1	laŋ55	㝗{(白)空㝩～，空蕩蕩},𦀬{毛線，～衫，假借字},啷{(白)傾鈴[leŋ55]哐[kʷʰaŋ55]～，器皿碰撞聲},唥{擬鈴聲；〈語〉毛線，～衫，又作𦀬字，一說法語laine}
laang4	laŋ21	啷{(語)象聲詞，呯[peŋ21]呤[leŋ21]嘭[paŋ21]～，劈哩啪啦}
laang5	laŋ24	冷
laap3	lap3	䁽{掃視，與覽對轉},擸{(語)包攬，與攬對轉，本字拉},拉{(白)包攬，與攬對轉，俗字擸}
laap6	lap2	垃{垃圾，本字擸𢶍},鱲{腌魚},鑞{錫鑞},蠟,蜡{同蠟字},臘,腊{同臘字},擸{折、碾；擸𢶍，又作垃圾/拉颯},搚,拉{拉雜（垃雜），拉颯（垃圾）}
laat3	lat3	喇{哈喇},𤊶{(白)熱、燙},鬎{鬎鬁，同瘌痢},癩{癩痢，同瘌痢},瘌{瘌痢；〈語〉毒蟲在皮膚上爬過},揦{塗抹}
laat6	lat2	列{(語)睡～～，成排地睡},𤊶{火貌},鯻,邋{邋遢},辣{辣椒，辛辣，老辣},蝲,剌{乖剌，剌謬}
laau1	lau55	寥{(白)又音，稀～～，疏～～},老{(語)～孃[nɛŋ55]、～爹[kɛ55]，母親、父親的敘稱；～佬，北方人的俗稱，老兄的官話摹音},撈{(文)撈魚；～籬[li55]，笊籬；～佬，北方人的俗稱，本字老，老兄的官話摹音}
laau2	lau35	摎{(語)～攪[kau22]，胡搞；糟糕、凌亂}
laau3	lau33	嫪{(白)淫蕩},髝{(白)詞綴，狂～～，緊張、發慌，過～，錯過時機}
laau4	lau21	撈{(文)打撈；～籬[li21]，笊籬}
lai2	lɐi35	利{(語)冇老～，不吉利},戾{(白)扭轉，睡～頸，落枕}
lai4	lɐi21	㰀,黧,黎,藜,蔾,犂{同犁字},犁,嚟{粵字，來，本字來},來{(白)過來，來到，出來}
lai5	lɐi24	劙,鱧,醴,豊,蠡,禮,澧
lai6	lɐi22	䚕{求視},𧢝,𥉆,𣛒,麗{美麗，麗質；麗水（在浙江），高麗（朝鮮）},迣{(又)},蠣,荔{荔枝},綟{青綠色},糲,礪,矖,癘,珕,欐,栃,攦,捩{琵琶撥法},厲{嚴厲},勵,利{(又)～市[ʃi22]，紅包},儷,例,丽
lak1	lɐk5	㪐{(語)～㩿，路不平或說話結巴，本字犖確，與掕掯（硠砊）對轉},肋{胳～底，腋窩},犖{(白)～確[kʰɐk5]，路不平或說話結巴，俗字㪐㩿，與掕掯（硠砊）對轉},嘞{(語)詞綴，跳～～，跳動貌，與㘄對轉，疑本字躒；象聲詞，𠽤[kʰek5]嚦[lek5]緙[kʷʰɐk5]～，各種事物}
lak6	lɐk2	㔹,鰳,肋{肋骨；打赤[tʃʰi33]～，打赤膊},簕{簕竹，簕欓；〈語〉植物的刺或魚刺，本字竻},竻{竹根；〈語〉植物的刺或魚刺，俗字簕},玏,泐,朸{(又)},扐,叻{石叻，叻埠，呵叻},勒{勒索；勒緊},仂{餘數}
lam1	lɐm55	冧{哄；〈外〉～把，號碼，英語number}
lam2	lɐm35	凜,稟{同廩字},檁,懍,廩{倉廩，廩食},壈
lam3	lɐm33	冧{垮塌，塌陷，～檔，倒閉，本字或爲陷，上古談部，另一說淋的引申}
lam4	lɐm21	啉{喹啉},霖,臨,箖,痳{同淋字，淋症},琳,淋{淋雨；淋鹽},林
lam6	lɐm22	㨆{殺也；〈語〉碼、堆叠，～磚，本字廩，與拉對轉},廩{(白)碼、堆叠，～磚，俗字㨆，與拉對轉}
lan1	lɐn55	噒{啃，或與吞字有關；飽滿，或與耣/稐有關}
lan2	lɐn35	溣{(語)弄髒，沾染},𡳞
lan3	lɐn33	碖{(白)掉落，～𩄝[ɬɔ21]𩄝[ɬɔ21]，紛紛落下貌}
lan4	lɐn21	侖{加侖},麟,鱗,驎,鏻,錀{金},鄰,遴,轔,輪,論{論語，俗讀議論之論},膦{膦軟},翷,繗,綸{滿腹經綸},粼,磷{白磷，磷礦，磷肥},瞵{注視},璘,燐{燐火},潾,淪{淪爲，沉淪},掄,嶙,崙{崑崙山},埨,圇,倫
lan5	lɐn24	屯{(語)溢出，與屯同源，滿也、盈也，上古文部},碖{石落貌}
lan6	lɐn22	吝{吝嗇},躪,論{議論；〈又〉論語，俗讀；〈語〉～盡，不利索、麻煩},藺,膦{有機化合物的一類},碖{石貌；大小勻貌},溣{水中曳船}
lang1	lɐŋ55	㘄{象聲詞；詞綴，跳～～，跳動貌，與嘞對轉，疑本字踉，另一說本字踜},揚{(語)篩（名、動），～箕，籮篩，～穀，簸穀，與揚同源，上古陽部}
lang3	lɐŋ33	掕{(語)半～掯，半途、半路，本字硠砊，與㪐㩿（犖確）對轉},硠{(白)半～砊[kʰɐŋ33]，半途、半路，俗字掕掯，與㪐㩿（犖確）對轉}
lang4	lɐŋ21	倰{長貌；〈語〉～鬙[ɬɐŋ55]，不整潔；詞綴，發氣～～，發怒貌},楞{發楞，又作發愣},掕{(白)攔截，與勒對轉},愣{發愣，同發楞},塄
lang5	lɐŋ24	棱{(語)鞭痕},稜{(語)鞭痕}
lang6	lɐŋ22	唥{冚唪～，全部}
lap1	lɐp5	拉{(白)套，～衫；哄，～人；俗字笠},笠{(白)斗笠，蓑笠},泣{(又)}
lap6	lɐp2	砬,鉝,笠{(文)},立
lat1	lɐt5	㪐{(白)脫落、掉，俗字甩},甩{(訓)脫落、掉，訓讀㪐}
lat6	lɐt2	㖀,葎,聿{(又)},篥,硉,率{效率},溧,栗,慄,律,垏,凓,傈,㪐{不穩},㗚{嘍㗚}
lau1	lɐu55	嘍{助詞},騮{(語)馬[ma55]～，猴子，又作馬留/馬流，一說源自沐猱},褸{大衣；口水～，涎布、圍嘴兒},蔞{(白)假～，蔞葉},蒟{(訓)假蒟，即假蔞（蔞葉），訓讀蔞},瞜,流{(語)新年～～，大過年的},摟{邀請；挑逗；（蒼蠅等）趴；披，～件衫；搜刮，～錢}
lau2	lɐu35	摟{摟抱}
lau3	lɐu33	漏{(語)遺漏、落下，～車、～口（結巴）；撿漏、在農地翻找，～花生、～番薯；遺漏物}
lau4	lɐu21	僂{佝僂},鶹,髏{(文)},騮{驊騮},餾,飀,鏐,鎦{鎦金},鎏,遛{逗遛},螻,蔞{蔞蒿},膢,耬{耬車},窶{甌窶},硫{硫磺},瞜{(又)},瘤,疁,留,瑬,琉{琉璃},瀏,漻{變化貌},漊{水名，漊水},流{流水；～嘢，劣質貨},樓,榴{石榴},旒,摎{姓},婁,嘍{嘍囉},劉,剅
lau5	lɐu24	塿,鋶,罶,縷{(又)},綹,簍,珋,熮,漊{水溝},柳,嶁
lau6	lɐu22	溜{水溜，急溜},鷚,陋{簡陋},鏤,鎦{鎦子},遛{遛彎},瘻{瘻管，痔瘻；～䏽，不整潔、臃腫},瘺,熘,漏{漏雨}
le1	lɛ55	咧{大大咧咧；唓～，話多、愛表現，本字啁嘐（嘐啁）},哩{語氣詞；〈外〉茄哩啡，龍套、小角色，英語carefree}
le3	lɛ33	罅{(白)}
le4	lɛ21	咧{(語)語氣詞，𠯔斜～，呸},離{(白)奇[kʰɛ21]～，古怪；～氣[hɛ33]，不修邊幅},罟{(語)〈名〉魚網；〈動〉～魚，網魚；註，民族語對音爲[r-/x-]，與漢語[k-/kʰ-]有對應}
le5	lɛ24	褦{(習)褦襶（衣着不整；吊兒郎當）；～㹃[fɛ35]，同褦襶}
lek1	lɛk5	叻{能幹，與靈對轉，一說本字𥌮/𦘊/㔹/力}
lek6	lɛk2	壢{(白)},癧{(白)淋巴結}
lem2	lɛm35	舐{(語)舔},舔{(語)舔，～碗，又作舐字}
lem4	lɛm21	熑{(白)火、燎},燫{(白)火、燎}
len3	lɛn33	摙{(語)打滾，俗字碾/輾}
leng1	lɛŋ55	僆{(訓)又音},鈴{(白)搖鈴聲},笭{(白)又音}
leng3	lɛŋ33	靚{(訓)漂亮，本字令，～笠笠，很漂亮}
leng4	lɛŋ21	零{(白)斤零重（一斤多重），十零隻（十多隻），九點零鐘（九點多鐘）},鯪{(白)鯪魚},靈{(白)～擎[kʰɛŋ21]，靈驗，靈的分音}
leng5	lɛŋ24	岭{(白)同嶺字},領{(白)衫領，衣領},嶺{(白)山嶺；地名，長堽嶺，石柱嶺}
leng6	lɛŋ22	炩{(白)攝～，閃電，與閃靂對轉}
lep3	lɛp3	甲{(語)穀～，穀殼，與甲同源，上古葉部}
let3	lɛt3	綟{(白)死/生～，死/活結，俗字纈},纈{(語)死/生～，死/活結，本字綟}
let6	lɛt2	列{(語)量詞，排；排～～，個挨個}
leu1	lɛu55	嫽{(白)挑逗},鷯{(白)鷯哥},撩{(白)～耳朵，掏耳朵；～起，掀起；～火棍，撥火棒},撈{(白)撈魚；同撩字，取也},寮{(白)茅～，茅屋},寥{(白)空～～，空蕩蕩；稀～～，稀疏貌、（粥）很稀；疏～～，稀疏貌}
leu2	lɛu35	繚{(白)繞，捲起}
leu3	lɛu33	嫪{(白)又音},𣩢{(白)枯萎},蔫{(語)枯萎，本字𣩢}
leu4	lɛu21	撈{(白)打撈；～籬[li21]，笊籬},獠{(白)獠牙}
li1	li55	剺{(語)撕，或作劙字},鬁{(白)鬎鬁，同瘌痢},釐{(白)一～子，一分錢},籬{(白)撈[lau55]～，笊籬},篱{(白)},痢{(白)瘌痢},璃{玻璃},喱{咖喱，啫喱},唎{(又)},哩{哩哩啦啦；花哩碌碌；唦[ʃa21]～躘[lʊŋ22]蹱[tʃʰʊŋ33]，莽撞},力{(語)苦力，英語coolie與其同源，俗作咕喱}
li4	li21	刕,麗{(又)麗水（在浙江），高麗（朝鮮）},鸝,鱺,驪,離{離別；去也，～開半寸，古讀去聲},釐{釐定，毫釐},醨,貍{貍貓，狐貍},蜊,蘺,罹,縭,籬{籬笆，籬下；撈[lɛu21/lau21]～，笊籬},篱{同籬字},离{同離字},璃{琉璃},狸{同貍字，狸貓，狐狸},犛,灕{灕江},漦{涎沫也},漓{淋漓盡致},梩,梨,杝{同籬字},嫠,厘{厘米，同釐米},劙{(又)},剺
li5	li24	俚,𢃇{粵字，帆，避諱反，轉讀音近利，本地不用},鯉,鋰,里{千里，里程，里弄},邐,裡{(習)同裏字},裏{(習)裏外；衣裏},理,浬,李,悝{憂傷},峛,履{(書)},娌,哩{英里的舊稱}
li6	li22	俐,鬁{鬎鬁，同瘌痢},詈,蒞{同莅字},莉,莅{莅臨，莅會},脷{舌頭，本字利，避諱折},痢{痢疾，白痢},猁,浰{(又)},唎,吏,厲{(語)厲害，本字利害},利{順利，利益；舌頭，俗字脷，避諱折；～市[ʃi22]，紅包}
lik1	lek5	力{(外)朱古力，英語chocolate},嚦{(語)象聲詞，𠽤[kʰek5]～緙[kʷʰɐk5]嘞[lɐk5]，各種事物}
lik6	lek2	㠣,𦘊,𥌮,鬲{古代炊具},靂,鎘{同鬲字},酈{姓},轢,躒{跳躍},藶,秝,礫,癧{(文)},瓅,瀝{瀝青，瀝血},濼{蕨科植物},歷{歷史},櫪,櫟{木名},朸,曆{日曆},擽{捎也},壢,嚦{嚦嚦},厤,力{力量，有力},仂{同力字}
lim2	lim35	斂{收斂},臉{臉頰；臉面},殮{裝殮，入殮}
lim4	lim21	奩,鬑,鐮,鎌,蠊,薕,臁,聯{(又)},簾{窗簾，簾幕},磏{礪石},燫{同熑字},熑{火不絕},濂,廉,帘{酒帘}
lim5	lim24	䭑{小吃},襝,蘞{白蘞、赤蘞},薟{白薟}
lim6	lim22	殮{(又)},瀲
lin1	lin55	先{(語)語流音變，用於句末，等下～},楝{(又)}
lin2	lin35	臉{(又)俗讀},鏈{(白)拉鏈，鏈條，本字鍊},鍊{(又)鍊條}
lin3	lin33	摙{(語)又音}
lin4	lin21	怜,鰱{鰱魚},連,褳,蓮,聯{(常)聯繫，聯合，對聯},漣,槤,憐
lin5	lin24	僆{孿生},鄻,璉{瑚璉},摙{擔；運}
lin6	lin22	摙{按},鰊,鏈{(文)},鍊{鍊金；鍊條，後作鏈},練,瑓,煉{冶煉，煉油},浰,楝{苦楝，楝樹}
ling1	leŋ55	令{量詞，一令紙},靈{(白)精～，機靈，精的分音},零{(白)孤零零、孤零清，又作孤伶伶、孤伶清},鈴{(白)～啷，搖鈴聲；～啷佬，貨郎；車～，單車鋼圈},笭{(白)年輕幼稚的，～崽（本義背篼嬰），詈語，俗字僆},拎{(書)},僆{(訓)年輕幼稚的，～崽（本義背篼嬰），詈語，本字笭},伶{(白)孤伶伶、孤伶清，又作孤零零、孤零清}
ling3	leŋ33	坽{(語)傾斜、陡；坡道，本字或爲嶺，阪也}
ling4	leŋ21	〇,齡,鴒,鯪{(文)},靈{靈活，神靈},零{零分，零頭，零售},陵,鈴{風鈴，鈴鐺},醽,酃,踜{跌倒},蛉,蔆,菱{菱角},苓,舲,聆,翎,羚,綾,笭{笭箵},稜{同棱字},祾,睖,瓴,玲,爧,澪,淩{水名},泠,欞,櫺,楞{同棱字；楞伽},棱{棱角，棱柱，模棱兩可},柃,昤,掕{止也},崚,岭{岭巆},姈,堎,坽{峻岸},囹,呤{呤呤；象聲詞，呯[peŋ21]～嘭[paŋ21]啷[laŋ21]，劈哩啪啦},凌{冰凌，凌厲},倰{欺凌},伶{名伶，伶俐},令{令狐，俗讀命令之令},㥄
ling5	leŋ24	岭{(文)},領{領錢，領導},嶺{(文)嶺南}
ling6	leŋ22	令{令人，命令；〈又〉令狐，俗讀},踜{踜蹬},炩{炩火},呤{嘌呤},另{另外（口語用另開）}
lip6	lip2	擸{理鬚髮},鱲{鱲魚，又稱桃花魚},鬣,躐,獵{打獵，獵人}
lit6	lit2	冽,鴷,迾,趔,裂,綟{麻綟},獵{(又)俗讀},烈,洌,捩{轉捩點},挒,咧{咧嘴},劣{(又)},列{排列，列隊}
liu1	liu55	寮{(白)又音，茅～，茅屋},鷯{(文)},熘{(又)},溜{溜走，溜冰，順口溜},撂{放下}
liu2	liu35	料{(白)塑料，材料，調料}
liu4	liu21	僚,𩯊,鷯{鷦鷯},髎,镽{細長},鐐,遼,蹽,聊,繚{繚繞},簝,瞭{瞭望},療,獠{獠牙},燎{燎原；火燎，古讀上聲或去聲},潦{潦草；潦倒，古讀同老},漻{水清貌},橑{(又)},敹,撩{撩動，撩撥},憭{憭慄},寮{茅寮，寮舍},寥{寂寥，寥廓},嫽{美好},嘹
liu5	liu24	了{了結，不得了},镽{長貌},釕{金屬元素，符號Ru},蓼{辣蓼（水蓼）},瞭{瞭解，明瞭},憭{聰慧}
liu6	liu22	尥{尥蹶子},𪤗,𣩢{敗也},釕{釕銱兒},炓{火光},料{預料，料想，料定},廖{姓}
lo1	lɔ55	囉{囉嗦；～柚，屁股},𦣇,螺{(白)陀螺；轉/捹～～，團團轉},籮{(白)百～，小孩滿百日；量詞，一～炭},囖
lo2	lɔ35	倮,裸{裸體},蠃{蜾蠃},蓏,臝,瘰{瘰癧},攞{拿、取；助詞，動詞後表動作方式，着，弱讀讀同左}
lo3	lɔ33	咯{語氣詞},𤓓,摞{摞起來}
lo4	lɔ21	囉{嘍囉},騾,鑼,邏{邏輯，巡邏},蠃{同螺字},螺{田螺，螺旋，陀螺},蘿{蘿蔔，藤蘿},腡{手指紋},羅,籮{名詞，～頭，籮筐；量詞，一～穀},玀{豬玀},欏
lo6	lɔ22	㱻
loe1	lœ55	𦧲{吐，疑本字唾}
loe2	lœ35	𦧲{揩擦，疑本字擄}
loek3	lœk3	掠{(又)},略{(又)}
loek6	lœk2	䂮,略,擽{擊也},撂{掠取，本字㨼},掠,圙
loeng2	lœŋ35	兩{斤兩，二兩},輛{車輛},啢
loeng4	lœŋ21	俍,量{測量},輬,踉{跳踉},莨{薯莨},良,綡,糧,粱,粮,簗,涼{冰涼},樑{房樑，脊樑},椋,梁{梁山，梁朝；姓},墚
loeng5	lœŋ24	䓣,魎,裲,兩{兩個，兩斤；～人好、～兄弟，猜碼口令，數字二},倆
loeng6	lœŋ22	亮,量{數量},踉{踉蹡},諒,惊{同悢字},悢{惆悵},哴{唴哴},倞{求；索取}
loi4	lɔi21	來{未來，來回，來信},錸,萊,淶,棶,徠{招徠},崍,倈{古族名；元雜劇俗稱小孩，倈兒；地名用字}
loi6	lɔi22	唻,賚,誺{誤},睞,徠{勞徠}
lok3	lɔk3	咯{吡咯},駱{駱駝；姓},餎{餄餎},雒,鉻{剃髮},酪{奶酪},落{(又)角落頭，前字調類化},絡,珞,犖{卓犖，犖確},烙{烙印，炮烙},漯{漯河市，本作螺},洛
lok6	lɔk2	樂{快樂},躒{卓躒},落{落雨，下落},硌{山上大石},濼{水名，濼水（在山東）}
lon1	lɔn55	卵{(又)～子，睾丸，～脬，陰囊；腏（戳物）懵懵，～脬似檸檬[mʊŋ35]，譏諷人稚嫩的俗語}
long1	lɔŋ55	啷{噹啷；鈴[leŋ55]～佬，貨郎}
long2	lɔŋ35	盪{(語)漱、涮洗，或爲來回盪的合音，另一說本字盪，上古陽部，俗字𠺘/𠻴},𠻴{～口，漱口，或與盪有關},𠺘{漱、涮洗，或與盪有關}
long3	lɔŋ33	閬{(白)架～，架子、形體，俗字𢲲},𢲲{架～，架子、形體，本字閬}
long4	lɔŋ21	㝗,鎯,鋃,郎,螂{蟑螂，螳螂（口語用馬螂扛）},蜋{同螂字},筤,稂,硠{石聲},瑯,琅{琳琅，琅琊},狼,榔{檳榔，桄榔},桹,廊,哴{哴吭}
long5	lɔŋ24	㙟{江、湖邊的地窪地},閬{閬中，閬苑},誏{同朗字},蓢,烺,朗{明朗，朗讀，疏朗},悢{懭悢},崀,塱{同㙟字},埌{地名，埌東、埌西，與㙟/塱同源},㮾
long6	lɔŋ22	㫰{晾},𧚅,誏{戲言},蒗,莨{莨菪},浪{風浪，浪費},晾{曬，本字㫰},埌{墳墓}
lot6	lɔt2	㖀{(語)走～～，魚貫而行}
lu1	lu55	嚕{嚕囌；遠指代詞，那，疑本字爾/若/夫},黸{鑊～，鍋底灰},髏{(白)骷髏},撈{(白)攪拌，乾～，乾拌；摻和，～亂；～世界，闖江湖}
lu2	lu35	佬{俗稱成年男性，本字老，另一說本字獠}
lu3	lu33	嚕{(又)遠指代詞，那，語流音變}
lu4	lu21	㗦{～嘈，吵鬧，又作嘮嘈},𡑍,鸕{鸕鶿},鱸{鱸魚},髝{急貌；高貌},驢{(又)},顱,鑪,鐒,醪,轤{轆轤},蟧,蘆{蘆葦},艫,臚,纑,盧,癆,牢,爐,瀘,櫨,廬{茅廬},嶗,壚,嘮{嘮叨，嘮嘈（同㗦嘈）},勞{勞動；慰勞，古讀去聲}
lu5	lu24	姥{姥姥},鹵{鹵素},魯,鑥,銠,蛯,虜,荖,老{老人，老師；～乸、～竇，母親、父親的敘稱},獠{蠻族},瀂,潦{潦水},滷{滷水，滷蛋},氌,櫓,橑,栳,擼,擄
lu6	lu22	嫪{嫪毐；姓},鷺{鷺鷥},露,酪{酒類},輅,路,賂{賄賂},蕗,耮,璐,澇{澇災，旱澇},潞
lui1	lui55	壘{(又)堡壘；〈語〉一～堆，一大堆，本字礧䃍/累墜},𨀤{鑽入；栽倒},𧒽,擂{(白)打}
lui4	lui21	嫘,靁,雷,鐳,羸,罍,纍{繩索},縲,累{果實累累，累贅},檑,擂{擂臺，擂鼓}
lui5	lui24	儡{傀儡},蘽,藟,蕾,絫,累{積累，傷痕累累},磊,癗,漯{同㶟/灅字},屢{(又)},壘{堡壘，壘球},儽
lui6	lui22	唳,類,酹{酹酒，奠酹},誄,耒,累{勞累，連累},礧{礧石},礌{同礧字，礌石},淚,戾{暴戾，乖戾}
luk1	lʊk5	熝{(語)燙},麓{山麓，麓林},轆{軲轆；〈語〉滾；仆仆～～，踉蹌},簏,磟{磟碡},碌{(白)忙碌，勞碌；碌碡；量詞，段},睩{(白)瞪}
luk6	lʊk2	㟤{兩山間低凹狹窄之地；地名用字},鹿,騄,陸,錄,醁,逯,趢,谷{谷蠡王},蓼{長大貌},落{(又)落雨，落來（下來），落去（下去），語流音變；猜碼時也作六的諧音},菉,綠,籙,稑{疾熟也；〈量〉簇、串，一穙[pʊk2]～，一嘟嚕，與哢對轉},祿,碌{(文)礦物名，石綠},睩,甪,琭,熝{提煉},漉,淥,氯,樚,椂{木名},摝{振、搖},戮,彔,坴,勠,六{第六，六藝；～位[wɐi35]位[wɐi35]、～位[wɐi35]（諧音祿位）、～來（諧音落來），猜碼口令，數字六},僇
lung1	lʊŋ55	窿{窟窿，本字竉},𢙱{(語)～路，迷路，一說與厖/尨同源，亂也},竉{孔穴，俗字窿}
lung2	lʊŋ35	攏{(白)合攏，靠攏}
lung3	lʊŋ33	躘{(白)又音，～～蹱[tʃʰʊŋ33]蹱[tʃʰʊŋ33]，踉踉蹌蹌}
lung4	lʊŋ21	䪊{䪊頭},𡃡{大聲},龍,隆,躘{躘踵},蘢,聾,籠{蒸籠，燈籠},窿{穹窿；煤礦坑道},礱,矓,癃,瓏,瀧{急流的水},漋,櫳,朧,曨,嚨
lung5	lʊŋ24	儱,隴,籠{籠統，箱籠},篢{箱籠，本字籠；地名用字},攏{(文)},壠{同壟字},壟{壟斷，田壟}
lung6	lʊŋ22	哢{鳥吟；〈量〉簇、串，一唪[pʊŋ22]～，一嘟嚕，與稑對轉，疑本字菶茸},𢙱{愚也},躘{(白)唦[ʃa21]哩[li55]～蹱[tʃʰʊŋ33]，莽撞},衖{里衖，同里弄},弄{里弄}
lyu4	ly21	膢{(又)},驢{毛驢，驢崽},閭
lyu5	ly24	侶,麿,鋁,褸{襤褸},裡{(書)},裏{(書)裏外},膂,縷{絲縷},穭,稆,漊{小雨不絕貌},櫚,梠,旅,履{(習)鞋履，履歷，讀同屢},屢,呂,僂{彎曲；迅速}
lyu6	ly22	慮,濾
lyun1	lyn55	攣{(語)鑽入；頭髮捲曲}
lyun2	lyn35	卵{雞卵，卵子，卵脬},𥽸,戀{戀愛，留戀}
lyun4	lyn21	侖{(老派)},𢺈{聚；擇},麟{(老派)},鸞,鱗{(老派)},驎{(老派)},鑾,鏻{(老派)},錀{(老派)},鄰{(老派)},遴{(老派)},轔{(老派)},輪{(老派)},論{(老派)},膦{(老派)},聯{聯繫，聯合，對聯；〈語〉縫製},翷{(老派)},繗{(老派)},綸{(老派)},粼{(老派)},磷{(老派)},瞵{(老派)},璘{(老派)},燐{(老派)},灤,潾{(老派)},淪{(老派)},欒,攣{痙攣},掄{(老派)},巒,嶙{(老派)},崙{(老派)},孿,埨{(老派)},圞{同圝字},圝{團圝},圇{(老派)},倫{(老派)}
lyun5	lyn24	孌,臠,脟{同臠字}
lyun6	lyn22	乱,躪{(老派)},論{(老派)},藺{(老派)},膦{(老派)},溣{(老派)},吝{(老派)},亂
lyut1	lyt5	捋{(語)滑落；滑～～，滑溜溜}
lyut3	lyt3	捋{(又)}
lyut6	lyt2	㗚{(老派)},鋝,酹{(又)},葎{(老派)},脟{脅肉；腸間脂},聿{(又)},篥{(老派)},率{(老派)效率},溧{(老派)},栗{(老派)},捋{捋袖},挘,慄{(老派)},律{(老派)},埒,劣{惡劣，劣質},凓{(老派)},傈{(老派)}
m2	m̩35	呣{表疑問}
m4	m̩21	唔{否定詞，本字毋/無，只用於老派的唔該（勞駕、謝謝）和唔通（難道），現已罕用，其餘用冇},毋{(語)否定詞，俗字唔}
m5	m̩24	五{(又)八月十五，前字順同化}
m6	m̩22	呣{表答應}
maa1	ma55	么{同嗎字},馬{(語)～騮[lɐu55]，猴子，又作馬留/馬流，一說源自沐猱},貌{(語)又音，～乎[wu21]/啊[a22]，副詞，頗、蠻，原讀的語流音變，俗作嗎胡/嗎啊},螞{螞螂（蜻蜓）},巴{(白)攀扶、扒着；～望[mʊŋ35]，盼望，原讀的逆同化},孖{(訓)孿生、連帶，與巴旁轉；雙孖井，古井又泛指地名，現爲文物點},嬤{俗呼母},媽{媽[ma21]媽，姑媽},嚜{語氣詞},嘛{喇嘛；唵嘛呢叭咪吽；黑～～，黑漆漆},嗎{語氣詞}
maa2	ma35	嗎{(語)是非疑問句助詞，俗作嘛字，好食～？},嘛{(語)句末疑問詞，用於是非問句，本作嗎字，好食～？}
maa3	ma33	嘛{語氣詞，停電吖～}
maa4	ma21	嘛{助詞},麻{黃麻；麻瘋，又作痲瘋},蟆{蝦蟆，又作蛤蟆},痳{同痲字},痲{痲瘋，痲疹},嫲{粵字，阿～，祖母，罕用，多數用奶奶}
maa5	ma24	傌{象棋紅方棋子名},馬{騎馬},螞{螞蟻，螞蟥；～螂扛，同馬螂扛，螳螂},碼{尺碼},瑪,獁{猛獁},榪{榪槎},嗎{嗎啡}
maa6	ma22	傌{漢代刑罰；同罵字},駡{同罵字},螞{螞蚱},罵{罵人},禡,榪{牀頭橫木}
maai1	mai55	㭛{(白)本義瓢，光～，禿子}
maai2	mai35	賣{(白)燒賣}
maai4	mai21	埋{埋伏，埋怨；～口，傷口癒合},霾
maai5	mai24	蕒,買
maai6	mai22	勱,邁,賣{買賣}
maak1	mak5	𢫦{(白)砍、鋤，～一刀}
maak3	mak3	掰{(訓)訓讀擘},擘{掰、張；詞綴，乾～～，乾貌，與繃對轉}
maan1	man55	慢{(白)慢[man22]慢},𢺳{扳、扣，本字扳；攀、扶，本字攀},脕{(白)～雞，未閹淨的公雞},攀{(白)攀、扶},摱,扳{(白)扳倒，扳回；通攀字，攀、扶}
maan2	man35	慢{(白)慢[man22]慢}
maan4	man21	蔓{蔓菁},鬘,饅{饅頭},頑{(訓)～皮，～固，訓讀蠻},謾{欺謾},蠻{蠻荒，野蠻；副詞，很（口語用貌乎，俗字嗎胡或嗎啊）}
maan5	man24	晚{晚上，早晚；排行最小的，～崽、～女、～叔}
maan6	man22	㵘,鰻{鰻魚，電鰻},饅{(又)},鏝,謾{謾罵},蔓{藤蔓，蔓延},蔄,萬,脕{肥澤也},縵,熳,澫,漫,曼,慢{慢車，快慢；〈語〉（稱物時）秤尾低},幔,嫚,墁,卍,万{同萬字}
maang4	maŋ21	盲,鄳
maang5	maŋ24	䁅{目有餘視；恚貌},黽{蛙屬},錳,蟒{(白)},螞{(又)螞蟻，後字逆同化，俗作蜢蟻},蜢{蚱蜢；～蟻，螞蟻，後字逆同化},莽{(白)},艋,猛,勐
maang6	maŋ22	孟{孟春，孟子}
maat3	mat3	㩢{拭也，俗字抹},鞨{鞨巾},抹{抹布，抹乾，本字㩢}
maat6	mat2	襪{(又)},𪒜{黑也}
maau1	mau55	䅦{虛鬆不實，又作泡字},貓{(文)},貌{(語)～乎[wu21]/啊[a22]，副詞，頗、蠻，原讀的語流音變，俗作貓胡/貓啊},猫{(文)},泡{(白)虛鬆不實，本字䅦}
maau4	mau21	矛{(文)},錨{(又)},蟊,蝥,茅{(文)}
maau5	mau24	卯,鉚,茆,牡{牡丹},泖,昴,峁
maau6	mau22	冒{(白)感冒，假冒，冒煙},貌{相貌，禮貌},皃
mai1	mɐi55	咪{麥克風},𠜱{(白)},米{(白)一百米，平方米}
mai4	mɐi21	蒾,醚{(書)},迷{(書)},謎{(書)}
mai5	mɐi24	媄{(又)},鎂{(又)},脒,美{(又)},米{大米，米粉},瞇{塵物入眼},眯{塵物入眼},渼{(又)},洣
mai6	mɐi22	咪{(語)否定詞，冇係的合音},袂
mak1	mɐk5	嘜{(外)罐頭盒，英語mug；～頭，模樣或招牌，英語mark；豬～，蠢豬，詈語},墨{(語)蚊[mɐn21]～，墨蚊、小咬},嚜{同嘜字；〈語〉瘦～喀[kʰɐk5]，很瘦，與蜢對轉}
mak6	mɐk2	䥑,默,麥,驀,陌{陌生},貘,貊,貉{同貊字},覛{察看},脉,脈,纆,癦,墨{筆墨，墨水},嚜{通默字},嘿{同默字},冒{冒頓},万{万俟，複姓}
mam1	mɐm55	𩛎{食～～，吃飯，童語，唵唵的順同化},𩜠{同𩛎字}
man1	mɐn55	坌{(白)灰塵大},蚊{(白)蚊蠅，蚊香},燜{(語)同炆字},炆{燒、燉},文{(白)一～銀，一元錢；細～崽，小孩子}
man2	mɐn35	問{(白)～人，訪人，問字古有尋訪義},抿{(又)},抆{(白)擦拭}
man3	mɐn33	呇{(語)泉水，又作汶字，本字湓；地名，呇屯（在馬山縣），呇塘（在賓陽縣）},璺{(白)又音，～峻[ɬɐn33]，邊緣；勉強},湓{(白)泉水，俗字呇/汶},汶{(語)泉水，又作呇字，本字湓}
man4	mɐn21	岷,馼,雯,闅,閿,蚊{(文)～墨[mɐk5]，墨蚊、小咬},苠,芠,聞{新聞，聽聞；名譽、名望，古讀去聲},緡,紋,碈,甿{田民，古讀同萌},瑉,琝,珉,玟,氓{百姓，古讀同萌},民,旻,文{文章，論文；文過飾非，古讀去聲},忞
man5	mɐn24	刎,黽{黽池},鰵,閩{閩越，讀同閔},閔,鈍{(語)鈍，刀～、針～，端組-泥明旁轉},笢,皿{(常)器皿，讀同敏},湣,泯,暋,敏{靈敏，敏捷},抿{抿酒，抿嘴},抆{拭也},憫,愍,呡,吻
man6	mɐn22	問{問題，訪問},紊{紊亂，有條不紊},璺{裂痕},汶{汶川縣，汶河}
mang1	mɐŋ55	掹{拉、扯、拔，本字絣},𠵼,蜢{(語)瘦～躿[kʰɐŋ55]，瘦貌，與嚜對轉},繃{(白)繃緊，面～，繃着臉（生氣），～得緪[kɐŋ55]，繃得緊；癒合，傷口～嗮；詞綴，乾～～，乾貌，與擘對轉},綳{(白)},絣{(白)拉、扯、拔，俗字掹}
mang2	mɐŋ35	䁅{(白)～盯[tʃɐŋ35]，暴躁、使性子},𤷪
mang4	mɐŋ21	㬟{(訓)未曾的合音，本地方言字⿰未曾},萌,盟,甍,朆{(訓)未曾的合音，本地方言字⿰未曾},䒐{䒐䒏，神不爽也}
map1	mɐp5	凹{(訓)～落去，凹進去，即塌之音轉（端組-泥明旁轉），地下也},塌{(白)凹，端組-泥明旁轉，俗字凹}
map6	mɐp2	䂿{(白)用石擲、用棍打，端組-泥明旁轉}
mat1	mɐt5	乜{什麼，本字物，本地不單用，必須以詞組（乜嘢、乜事）成句},黴{(訓)發～，發黴，與沫/歿同源，上古月部},霉{(訓)}
mat6	mɐt2	勿,謐,襪,蜜,蔤,芴{蒠菜；有機化合物},物,沕{沕穆},日{(語)今/昨～，晚日的合音，合音後無晚義，另一說今日前字順同化},密,宓{安靜},嘧
mau1	mɐu55	踎{蹲，兜～，寒磣、寒酸，一說本字貓}
mau3	mɐu33	謬{(又)荒謬，前字調類化}
mau4	mɐu21	侔,鍪,謀,蛑,繆{綢繆},眸,牟,毪,哞,呣{同謀字；象聲詞}
mau5	mɐu24	某,畝,牡{(又)}
mau6	mɐu22	懋,貿,謬{謬論，荒謬},袤,茂,繆{同謬字，紕繆；姓},瞀,楙
me1	mɛ55	乜{～斜[tʃʰɛ21]，斜視},𧋦{(白)塘～，蜻蜒，疑本字螟/尾},羋{羊叫聲},孭{動詞，揹，本字不明},孖{(白)～指，六指，與裨旁轉},哶,咩{羊叫聲；羊～～，童語；乜嘢的合音，什麼東西、什麼；本地不用作句末語氣詞（包括反問），而是用啊}
me2	mɛ35	乜{歪，借～，讓一讓，本字佊},歪{(訓)斜，本字佊，俗字乜},佊{(白)歪，借～，讓一讓，俗字乜}
me4	mɛ21	乜{(語)～斜[ɬɛ21]，醉態；～酒，飲酒},瀰{(白)～瀰[mɛ35]，乳房；～水，乳汁；又作彌字},彌{(白)～彌[mɛ35]，乳房；～水，乳汁；又作瀰字}
me6	mɛ22	乜{姓}
mek1	mɛk5	嚜{(語)瘦～喀[kʰɛk5]，很瘦，與蜢對轉}
men1	mɛn55	翻{(白)～開，～書}
men2	mɛn35	抆{(白)又音}
men3	mɛn33	璺{(白)～峻[ɬɛn33]，邊緣；勉強}
meng2	mɛŋ35	蜢{(語)瘦～躿[kʰɛŋ35]，瘦貌，與嚜對轉}
meng4	mɛŋ21	名{(白)名字，出名}
meng6	mɛŋ22	命{(白)救命}
met1	mɛt5	屘{(語)～名，最後一名；～～屎，倒數第一，童語；本字蔑，末也},蔑{(白)末也，～名，最後一名，～～屎，倒數第一，童語，俗字屘}
met6	mɛt2	篾{(白)竹篾}
meu1	mɛu55	喵{(白)},貓{(白)花貓，貓狗},猫{(白)同貓字}
meu2	mɛu35	𠴕{(白)～示，愛哭}
meu4	mɛu21	矛{(白)矛盾，長矛},茅{(白)茅屋，茅草；～寮[lɛu55/liu55]，茅屋}
mi1	mi55	咪{貓咪；唵嘛呢叭咪吽；～～摩摩，動作慢，一說本字靡},𧋦,瞇{瞇眼；笑瞇瞇},睸{閉目},眯{眯眼；笑眯眯},溦{(白)溦溦雨，又作微微雨},微{(白)微微雨，又作溦溦雨；微微風},彌{(白)阿彌陀佛},屘{末尾的，最小的，本字尾},尾{(白)最～，後～，收～，俗字屘}
mi2	mi35	味{(白)臘味，滷味，一味}
mi3	mi33	沕{(語)潷；～水，潛水}
mi4	mi21	䉲,𪎭{𪎭子},𥮜,黴{(又)},麋,鶥,靡{奢靡，靡費},霉{(又)},鎇,醾,醚{(習)乙醚},郿,迷{(習)迷路，迷信},謎{(習)謎語，猜謎},蘼,薇,蒾{(又)},縻{羈縻，綆縻},糜{粥；糜爛；同𪎭字，糜子},眉,瑂,獼,瀰{瀰漫},濔,溦{小雨},湄,楣,微{微小，細微，稍微（口語用稍爲）},彌{彌補，彌月},嵋,冞
mi5	mi24	亹{亹亹},靡{披靡，風靡，俗讀奢靡之靡},鎂{鎂棒，鎂光燈},艉,美{美麗，優美，舊讀},羋{姓},渼,渳,敉,弭,尾{尾巴},媄,娓
mi6	mi22	味{味道，味精},魅,菋,未,昧{(又)},寐{夢寐以求},媚{明媚}
mik1	mek5	掰{(訓)又音},擘{(又)用指甲掐}
mik6	mek2	冪,覛{同覓字},覓{尋覓，覓食},蓂{菥蓂},糸{細絲},汨
min1	min55	麪{(白)形容詞，薯類很粉},麵{(白)}
min2	min35	面{(白)畀面，場面，裏面，外面}
min4	min21	杣{(又)},𥾝{(白)細，切～啲，切細點},綿{海綿，綿密；〈語〉細，切～啲，切細點，一說本字𥾝},眠,棉
min5	min24	丏,黽{(又)黽池},鮸,靦{靦腆},腼{腼腆，同靦腆},緬{緬懷，緬甸},眄,澠{地名，澠池（在河南）},湎,沔,愐,娩{分娩},勔,勉,冕,免,偭
min6	min22	面{面對，面積，洗面，腳面},麵{同麪字},麪{麪條，麪粉}
ming4	meŋ21	冥,鳴,銘,螟{螟蛉},蓂{蓂莢},瞑,溟,洺,暝,明,名{(文)莫名，名聲}
ming5	meŋ24	皿{器皿},酩,茗
ming6	meŋ22	命{命令}
mit1	mit5	搣{撕、掐、掰}
mit6	mit2	滅{消滅，滅火},𥾝{細也},衊{誣衊},蠛{蠛蠓},蔑{輕蔑，蔑視},篾{(文)}
miu1	miu55	喵,瞄{(白)瞄一眼}
miu2	miu35	𠴕{撇嘴}
miu4	miu21	描,鶓,苗,瞄{瞄準}
miu5	miu24	杪{樹杪，歲杪},邈{同藐字},藐,緲,窈{窈窕，讀同渺},秒,眇,渺,淼,杳{杳無音信，讀同渺}
miu6	miu22	妙,繆{姓},玅{同妙字},廟,庿,庙
mo1	mɔ55	么{同麼字},麽{同麼字},麼{甚麼，幺麼小醜},魔,饃{饃巴，泡饃，又作饝/𩞁字},糢,無{(語)南～（喃嘸）佬，道士和尚},模{模範；模子},摹{摹仿，又作模仿},摸{撫摸，偷摸},摩{摩擦，觀摩，按摩；咪[mi55]咪[mi55]～～，動作慢},尛,嬤{老婦，嬤[mɔ21]～},嚤{咪咪～～，動作慢，本字摩},嘸{(語)喃～（南無）佬，道士和尚},仫{(習)仫佬族，讀同麼}
mo2	mɔ35	麼{(語)是非疑問句助詞，記得～？},麽{(語)}
mo4	mɔ21	劘,麿{(又)},饃{(又)},蘑{蘑菇},藦{蘿藦},膜{膜拜},磨{(動)磨刀},模{(又)},摹{臨摹，摹本}
mo6	mɔ22	磨{(名)石磨},耱
mok1	mɔk5	𢷕{敲打，～一棍，與㩧旁轉；～～，木魚，罐頭盒}
mok3	mɔk3	摸{約摸，同約莫，前字調類化},莫{(白)約莫，又作約摸，前字調類化},膜{(白)薄膜}
mok6	mɔk2	寞,鏌,鄚,邈{遠也，渺也},莫{莫非；姓},膜{薄膜},瞐,瘼,漠,幕
mong1	mɔŋ55	杧{杧果},虻{(又)},芒{芒果，麥芒，芒草},牤{(又)}
mong4	mɔŋ21	亡{死亡，亡故},邙,蝱{同虻字},虻{牛虻},茫,芒{芒種，光芒},硭,甿{曠野},牻,牤{牤牛},氓{流氓},忙,忘{(又)},尨{長毛狗},厖{大；紛亂；姓}
mong5	mɔŋ24	壾,魍,輞{車輞},蟒{(文)},莽{(文)},茻{草叢},罔,网,網,漭,惘
mong6	mɔŋ22	妄,望{希望，望見},忘{忘記，遺忘}
mu1	mu55	巫,髦{(又)},誣,毛{(白)發～，發黴}
mu2	mu35	母{(白)妗～，舅母，阿～，姨媽}
mu4	mu21	嫫,鵐,髦,謨,蕪,無{有無，無論},氂{氂牛},毛{毛筆，鴨毛},毋{毋庸置疑},旄{幢；旄牛}
mu5	mu24	侮,𧿹,鵡{鸚鵡},鉧,茻{宿草},舞,碔,珷,潕,母{母親，父母},武,拇,憮,廡,嫵,姥{老婦人},姆,嘸{否定詞},冇{不、別、沒，無有的合音，本地合音後只表否定不表沒有（不存在義），不單用，必須以詞組（冇有、冇係）成句，不可用於句末，語流中易讀陰去；郊區有讀[mɐu24]音，置句末表疑問}
mu6	mu22	冒{感冒，假冒，冒煙},鶩,騖,霧{霧水，大霧},芼,耄,眊,瑁,暮,旄{同耄字},戊,慕,帽,婺,墓,募,務
mui1	mui55	妹{(白)妹崽，妹丁},枚{(又)}
mui2	mui35	妹{(白)細妹，妹[mui21]妹，阿妹}
mui4	mui21	媒,黴{發黴，黴菌，讀同梅},霉{同黴字},酶,莓,脢{～肉，裏脊肉；背～，背骨兩側肌肉，泛指背脊；背～骨，脊樑骨},玫,煤,梅,枚
mui5	mui24	每,浼
mui6	mui22	妹{姊妹，姐妹，表妹},痗,瑁{(又)玳瑁},沬,昧
muk1	mʊk5	摸{(語)掏，～荷包}
muk6	mʊk2	仫{(書)},鉬,苜,穆,睦,目,牧,沐,木,凩
mun4	mun21	亹{亹源},顢,鞔,門{大門，門口},鍆,蹣{(又)},瞞,璊,捫{捫心},們
mun5	mun24	滿,蟎
mun6	mun22	悶,燜,懣
mung1	mʊŋ55	檬{(白)},𡁏{(語)（薯類）膨鬆粉麪，本字蓬},蓬{(白)（薯類）膨鬆粉麪，俗字蒙/𡁏},蒙{(白)遮蓋，～頭睡覺；天～～光，天蒙蒙亮},濛{(白)～～雨，毛毛雨}
mung2	mʊŋ35	懞{同懵字},檬{檸檬，檸檬鴨},望{(語)巴[ma55]～，盼望，前字受後字逆同化},懵{懵懂}
mung4	mʊŋ21	㠓,𡁏{言不明},鸏,蠓{蠓蟲},蒙{蒙受，啓蒙；姓},艨,礞,矇{矇騙，矇混},瞢,獴,濛{濛濛細雨，溟濛},朦{朦朧},曚,懞{敦厚貌},幪,尨{尨茸}
mung6	mʊŋ22	夢
mut3	mut3	抹{抹摋，塗抹},秣
mut6	mut2	妺,𩑦{頭潛入水中，後作沒},靺,茉,沫{泡沫},沒{沉沒；沒有},歿{亡歿},末
naa1	na55	那{姓，俗讀那邊之那},𪐀{(文)～褦，牽扯},𤸻,𤶸{傷疤；補丁，補～；本字𪐀，由粘連義引申而來},𠸎
naa2	na35	乸{母、雌，一說本字女，上古魚部}
naa4	na21	哪{哪吒},鎿,挐{同拏字},拿{捉拿，拿手，本字拏},拏{牽也；執持，後作拿；拘捕，後作拿},娜{人名用字},嗱{嘆詞，表指向，本地用呢[nɛ21]}
naa5	na24	哪{哪個，哪怕},𦰡,那{那邊，又這又那；〈又〉姓，俗讀；〈語〉屌～媽（後起詞），詈語，你阿的合音，語流中易讀陰去，又讀[nia24/33]，本地原始用法爲屌你媽㞓}
naa6	na22	哪{語氣詞，啊字受前字韻尾n的連讀音}
naai1	nai55	奶{(白)阿～，祖母；二～，小老婆}
naai2	nai35	奶{(白)奶[nai21]～，祖母}
naai3	nai33	帶{(白)連帶，～球射門，端組-泥明旁轉，俗字𠮨},𠮨{連帶，～球射門，即帶之音轉（端組-泥明旁轉）}
naai5	nai24	乃,鼐,迺,艿{芋艿},氖,嬭,妳{同嬭字},奶{牛奶，奶嘴}
naai6	nai22	褦{(書)}
naak3	nak3	𪐌{(又)粈[niu55]～～，很黏糊}
naam1	nam55	南{(語)～無（喃嘸）佬，道士和尚},喃{(白)喃經（唸經）；嘮叨；～嘸（南無）佬，道士和尚；～咇[pɛt2]咇[pɛt2]，囉嗦、嘮叨}
naam3	nam33	揇{(白)量詞，拃；測長度},𨂾{跨、邁，可能由揇引申而來}
naam4	nam21	南{南方},遖,蝻{蝻子，蝗蝻},蚺{～蛇，蟒蛇},萳{草名},男,楠,抩,囡,囝{同囡字},喃{(文)呢喃，喃喃自語}
naam5	nam24	揇{搦，與㘝對轉},萳{草長弱貌},腩{牛腩，肚腩}
naam6	nam22	婻
naan3	nan33	㫱{(白)蚊蟲叮咬起的包},𧕴{蚊蟲叮咬起的包，本字㫱},𦍀{(白)絎，粗縫},𢺋{絎，粗縫，本字𦍀}
naan4	nan21	難{難易}
naan5	nan24	㫱{溫溼},赧,戁{恐懼}
naan6	nan22	㫱{赤色},𦍀{縕也},難{患難}
naang1	naŋ55	鬤{(白)鬞～，窩囊，不整潔}
naang3	naŋ33	儾{(語)吊～～，吊貌}
naap3	nap3	㘝{(白)搛，與揇對轉，～菜}
naap6	nap2	㘝{攝取},鈉,衲,納{出納，收納；〈語〉（植物子實）飽滿},吶{吶喊，嗩吶},䪏
naat3	nat3	捺{(常)撇捺，前字調類化},焫{燙，～手；烙，～機[kɐi53]，烙鐵；與熱同源，上古月部}
naat6	nat2	捺{撇捺},痆
naau1	nau55	孬
naau4	nau21	呶,鐃,錨{拋錨，讀同鐃},蟯{(又)},硇,猱,橈{曲折，曲木},撓{阻撓，百折不撓},峱
naau6	nau22	淖{泥淖},鬧,臑{牲畜前肢}
nai4	nɐi21	伲{(又)},臡,泥{泥土},尼{(又)尼龍，尼姑，讀同泥},坭
nak1	nɐk5	𪐌{～牙，結巴}
nak6	nɐk2	𪐌{(又)粈[nɛu55]～～，很黏糊}
nam1	nɐm55	恁{(語)土氣，本字𦛚，與䏙旁轉},𦛚{(語)土氣，俗字恁，與䏙旁轉}
nam2	nɐm35	恁{思考、想，俗字諗},諗{(訓)訓讀恁，思考、想}
nam4	nɐm21	腍{(語)（肉類）松軟、爛熟，～癟[pɛt2]癟[pɛt2]，軟綿綿，～善，人善良軟弱，與䪏/𥹉對轉，或爲燂之音轉（端組-泥明旁轉）}
nam5	nɐm24	稔{熟稔，稔色，素稔}
nam6	nɐm22	淰,𦛚{肥貌}
nan1	nɐn55	戁{(白)肉～，肉麻；噁心}
nan2	nɐn35	撚{(語)擺弄、玩弄，～化，捉弄，～菜，做菜，～手，拿手；挪挪～～，磨磨蹭蹭}
nang1	nɐŋ55	𤹍{～雞，瘡疤，一說與囊同源}
nang3	nɐŋ33	褦{(語)連着，粘連}
nang4	nɐŋ21	能{才能，能夠；～願，寧願，能字古有寧可義}
nap1	nɐp5	粒{一粒，顆粒，與沓旁轉},錔{(白)閉，端組-泥明旁轉}
nap6	nɐp2	𣲷{潮溼，與溚旁轉},𥹉{黏糊，與腍對轉，與搭旁轉；動作慢}
nat1	nɐt5	䵒{身～，痠軟，即汗衣黏身，又作䵑字}
nat6	nɐt2	吶{同訥字},訥,肭{肥貌},抐
nau1	nɐu55	嬲{生氣，本字獳},獳{(白)生氣，俗字嬲}
nau2	nɐu35	妞,鈕{按鈕，電鈕，旋鈕；同紐字，鈕釦},紐{紐釦，秤紐，紐帶},狃,杻{木名},朽,扭,忸{同狃字；〈又〉忸怩}
nau6	nɐu22	檽,膩{(語)本字腬},腬{膩},耨,獳{犬怒貌；姓}
ne1	nɛ55	呢{語氣詞，我把遮～？},𪐀{(白)粘貼}
ne2	nɛ35	呢{(語)表提請注意或指向}
ne4	nɛ21	呢{(語)表祈求或指向}
nem1	nɛm55	拈{(白)拈起，與鑷對轉},稔{同棯字},棯{(白)花/番～，番桃、桃金娘果實，又作稔/捻字},捻{同拈/棯字}
nen1	nɛn55	脌{(白)},𢆡{(白)}
nen2	nɛn35	捻{同撚字，摁、壓，與捏對轉},輾{水輾，後作碾},輦{車輦},碾{碾碎，水碾},攆{攆走},撚{用手指搓；摁、壓，與捏對轉}
neng1	nɛŋ55	娘{(語)同孃字},孃{(語)老[lau55]～，母親的敘稱}
neng2	nɛŋ35	䉴{(白)魚～，魚簍},頂{(白)量詞，一～帽，一頂帽，老派用法，端組-泥明旁轉}
neng3	nɛŋ33	褦{(語)又音}
nep1	nɛp5	嗒{(白)蚊蟲咬，端組-泥明旁轉，俗字囁},𠱃{(白)凹，本字埝},埝{(白)凹},囁{(訓)蚊蟲咬，即嗒之音轉（端組-泥明旁轉）}
nep3	nɛp3	鑷{(白)鑷子；夾，與拈對轉}
net1	nɛt5	𦛠{(語)矮～～，矮貌}
net6	nɛt2	捏{(白)按壓，與撚對轉}
neu1	nɛu55	粈{(白)黏}
neu4	nɛu21	嫋{(白)細長柔軟，軟/長/高～～}
ng2	ŋ̍35	嗯{表疑問}
ng4	ŋ̍21	吳,鼯,鋙{錕鋙},郚,蜈{蜈蚣},珸,浯,梧{梧桐},峿{嶇峿},唔{嘆詞，思忖聲},吾
ng5	ŋ̍24	五{五個，八月十五},迕,牾,旿,忤,午,伍,仵
ng6	ŋ̍22	互{(又)俗讀},誤,痦,焐,晤,摀,捂,悟,寤,嗯{表答應}
ngaa1	ŋa55	呀{(語)象聲詞，哭～～，大聲地哭，元音象義},椏{椏杈，又作枒杈},枒{枒杈，又作椏杈}
ngaa4	ŋa21	伢{小孩子},衙,蚜,芽,牙,涯{(又)},崖{(又)山崖，懸崖；～鷹，老鷹，引申指風箏，俗作牙鷹；～巘[jin55]，危險，俗作牙煙/崖广，另一說危險音變},岈{嵖岈}
ngaa5	ŋa24	佤,雅,疋{通雅字},瓦{瓦片；瓦解},厊
ngaa6	ŋa22	枒{～槎，佔地、霸道},𧧝{～𧨊，囉嗦、糾纏},閕{開裂也},迓,訝,砑{砑平}
ngaai1	ŋai55	𠊎{～話，客家話，本字我，摹客家音}
ngaai4	ŋai21	厓,睚,涯{天涯，生涯},捱{捱打，捱苦},挨{同捱字，挨打},崖{山崖，懸崖},堐
ngaai6	ŋai22	砹,艾{艾草，艾葉；〈又〉自怨自艾}
ngaak6	ŋak2	逆{(語)},額{(白)名額，數額}
ngaam1	ŋam55	啱{剛剛、恰好、合適，一說本字嚴，另一說本字𧬌/諴}
ngaam4	ŋam21	儑{不慧},礹{同巖字},癌{癌症，肝癌},巖{巖洞，巖壁},嵒,岩{岩石，岩漿}
ngaam6	ŋam22	儑{傝儑}
ngaan4	ŋan21	研{(語)又音},顏{容顏；顏色},頑{(又)},虤
ngaan5	ŋan24	眼{(文)},齴{高峻貌}
ngaan6	ŋan22	贋,鴈,雁,贗
ngaang2	ŋaŋ35	硬{(白)硬係，硬要，夾硬（強行），生硬（強行），充硬（硬裝）}
ngaang6	ŋaŋ22	硬{堅硬，硬撐（結實），硬頸（固執）}
ngaap3	ŋap3	哈{(語)開～～，咧開貌}
ngaat6	ŋat2	䡾{(又)},齧{(白)又音},齕{(白)又音},扤{(文)碾壓，與研對轉},囓{(白)},嚙{(白)}
ngaau1	ŋau55	撓{(文)},𢯎{(文)}
ngaau3	ŋau33	嗷{(語)詞綴，煙～～，煙燻火燎，綠～～，綠油油}
ngaau4	ŋau21	崤,𢳆{(白)},餚,肴,爻,熬{(白)熬肉；〈又〉熬夜},淆,洨,殽,摮{(白)搖晃}
ngaau5	ŋau24	咬{(文)}
ngaau6	ŋau22	樂{仁者樂山}
ngai1	ŋɐi55	磑{(白)哀求，俗字𠼮/𠱓},𠼮{哀求，又作𠱓字，本字磑},𠱓{哀求，又作𠼮字，本字磑}
ngai4	ŋɐi21	倪{(書)},𨺙,齯,麑,鯢,鮠,霓{(書)},輗,蜺{寒蟬},猊,洈,桅{桅杆},巍,嵬,峗{三峗},危
ngai5	ŋɐi24	峗{山高貌},顗,頠,隗{高；姓},蟻,螘,艤,硊{磈硊}
ngai6	ŋɐi22	乂,魏,詣,藝,蓺,艾{自怨自艾},羿,睨{睥睨},毅{毅力，剛毅},栺{枍栺},堄{埤堄},囈,刈{割，刈草，刈麥},僞{虛僞},偽{同僞字}
ngak1	ŋɐk5	呃{(語)欺騙，愚惑的合音（愚字古疑母），又作眲字},眲{欺騙，愚惑的合音（愚字古疑母），俗字呃}
ngak6	ŋɐk2	額{額頭}
ngam1	ŋɐm55	顉{(白)～頭，點頭，與𩪤對轉}
ngam4	ŋɐm21	吟{(白)～沉，嘮叨，古作沉吟，與噏/𡀾對轉},啽{寐聲}
ngam5	ŋɐm24	㜝{含怒貌},趛{(又)}
ngan1	ŋɐn55	奀{瘦小，本字不明，疑本字斤}
ngan3	ŋɐn33	䟴{搖晃，或爲振振的連讀音變，與扤對轉}
ngan4	ŋɐn21	仁{(白)果仁},齦{牙齦},齗,銀,鄞,誾,珢,狺,垠,圻{同垠字},嚚
ngan6	ŋɐn22	垽,韌{(白)煙（蔫）～，食物有勁道},憖
ngang1	ŋɐŋ55	戇{(語)癡～～，瘋癲貌，傻～～，傻乎乎，或與緪有關}
ngang2	ŋɐŋ35	戇{(語)發愣，愣住，或與耿有關}
ngang6	ŋɐŋ22	蹬{(白)徛～～，直直地站着}
ngap1	ŋɐp5	噏{(語)胡說，又作𡀾字，與吟/啽對轉},𩪤{(又)},𩕟{(又)},𡀾{(語)胡說，又作噏字，與吟/啽對轉}
ngap6	ŋɐp2	哈{(語)動口貌},𩪤{～頭，點頭，與顉對轉，又作𩕟字},𩕟{同𩪤字},𡀾{眾聲},礘,歞{癡貌},岋{動貌}
ngat1	ŋɐt5	忔{(白)又音，～失[ʃɐt5]，吝嗇，與齞對轉},胺{(語)屙～尿，尿淋}
ngat6	ŋɐt2	仡{壯勇},阢,迄{迄今},訖{收訖},矻,疙{癡貌},汔,杌{杌子},扤{(書)本讀，搖動，與䟴對轉},忔{心不欲也},屼,屹{屹立},圪{牆高貌},卼,兀
ngau1	ŋɐu55	佝{(白)佝僂},鉤{(白)魚鉤；鉤住},鈎{(白)同鉤字},軥{(白)軥心木},痀{(白)},句{(白)曲也，俗作勾；高句麗；姓，句踐},勾{(白)勾消；勾當}
ngau4	ŋɐu21	牛{水牛，牛奶；〈語〉錢的喻稱}
ngau5	ŋɐu24	偶{配偶；偶然},藕,蕅,耦
ngau6	ŋɐu22	吽{俗字，～哣，迷糊、不清醒，本地又引申爲古板、難溝通，疑本字䠗逗/譳䛠}
nge1	ŋɛ55	呀{(語)象聲詞，哭～～，小聲地哭，元音象義},𡃀{𡃀[ŋɛ21]～，二胡},椏{(白)樹～，樹杈},枒{(白)樹～，樹杈}
nge2	ŋɛ35	𡃀{推門聲}
nge3	ŋɛ33	鋸{(白)又音}
nge4	ŋɛ21	𡃀{～𡃀[ŋɛ55]，二胡}
ngen1	ŋɛn55	齞{(白)齜、露齒；吝嗇，與忔對轉}
ngen4	ŋɛn21	研{(語)碾、砑，與扤對轉},顏{(白)罕讀}
ngen5	ŋɛn24	眼{(白)}
ngep6	ŋɛp2	哈{(語)口開～～，嘴合不攏}
nget1	ŋɛt5	忔{(白)～失[ʃɛt5]，吝嗇，與齞對轉}
nget6	ŋɛt2	嚙{(白)},齧{(白)啃、咬},齕{(白)啃、咬；〈語〉齮[ŋi21]齮[ŋi55]～～，矯情、支吾},扤{(白)碾壓，與研對轉；捱～，磨蹭},囓{(白)}
ngeu1	ŋɛu55	撓{(白)抓撓，俗字𢯎},𢯎{(白)抓撓，本字撓}
ngeu5	ŋɛu24	咬{(白)咬人，反咬}
ngi4	ŋi21	齮{(語)～齮[ŋi55]齕齕，矯情、支吾}
ngik6	ŋek2	嶷{(又)},逆{(又)}
nging4	ŋeŋ21	迎{(語)～腳，踮腳}
ngo4	ŋɔ21	俄,鵝,鋨,訛,蛾{飛蛾，燈蛾},莪,硪,涐,峨,娥,囮,哦{吟哦},吪{行動；感化}
ngo5	ŋɔ24	我
ngo6	ŋɔ22	卧,餓,臥{臥室，躺臥}
ngoe3	ŋœ33	鋸{(白)宰、殺，～客，宰客，已罕用}
ngoi4	ŋɔi21	呆{呆板，本字獃},騃,磑{磑磑},皚,獃{獃板}
ngoi6	ŋɔi22	外,艾{(又)艾草，艾葉},礙
ngok6	ŋɔk2	噩,𩓥,𥔲,齶,鸑,鶚,鱷,鰐,顎,鍔,鄂,諤,萼,樂{音樂},愕,嶽{五嶽},崿,岳{姓}
ngon6	ŋɔn22	岸,犴{狴犴；牢獄}
ngong3	ŋɔŋ33	戇{(訓)傻、呆，～居，愚戇的合音（愚字古疑母），與愕對轉}
ngong4	ŋɔŋ21	卬{我也；通昂字；姓},昂{昂首}
ngong5	ŋɔŋ24	仰{(白)仰頭}
ngu4	ŋu21	㟼,𢳆{搖晃，本字摮},鼇,鰲,驁,鏖{(又)},遨,螯,聱,翱,璈,獒,熬{熬夜},敖,摮{擊；〈語〉搖晃，俗字𢳆},廒,嶅,嗷{嗷嗷待哺}
ngu6	ŋu22	傲,鏊{烙餅用具},奡
nguk6	ŋʊk2	摝{(語)用力搖動，與𢳆/摮對轉}
ni1	ni55	呢{(語)細～～，小貌，本字稚（俗字啲），知組-端組-泥明旁轉；唵嘛呢叭咪吽；粵字，這，本字爾，本地用阿/亞，本字箇}
ni4	ni21	伲,霓{(習)霓虹，霓虹燈},鈮,跜,誼{(常)讀聲符宜},觺,籾,禰{姓},疑,怩,嶷{九嶷山},尼{尼龍，尼姑；姓；人名用字},宜,妮,呢{呢絨，呢喃},倪{(習)端倪；姓}
ni5	ni24	你,鉨{化學元素},薿,禰{考廟},狔,柅,旎,擬,您,妳{同你字，專指女姓},儗{僭越}
ni6	ni22	儗{佁儗},誼{友誼，情誼},膩{油膩},眲{輕視},泥{拘泥}
nik1	nek5	搦{(習)拿，與擰（拎）對轉},𪐌{黏；～住，停滯}
nik6	nek2	匿,鷊,鷁,鬩{鬩牆，讀同匿/慝},逆{逆風，忤逆，與迎對轉},虉,溺{溺水，溺愛},暱,昵,慝{隠情飾非},嶷{岐嶷}
nim1	nim55	拈{(文)},黏{黏土，黏性},粘{粘貼；同黏字},研{(又)研究，讀同黏/粘},棯{(文)}
nim4	nim21	鮎{鮎魚},鯰{同鮎字}
nim6	nim22	唸{唸書，唸經},驗{試驗，驗證},念{思念，想念},廿{(文)},埝{土埝，堤埝}
nin1	nin55	脌,𢆡,蔫{枯萎；食物不鮮}
nin4	nin21	年
nin5	nin24	涊,蹨
ning1	neŋ55	丁{(白)細～～，小貌，端組-泥明旁轉，俗字嚀},擰{提，與搦對轉，本字拎，來母讀泥母，聲母演變同粒字},拎{(習)提，俗字擰},嚀{(語)細～～，小貌，即丁之音轉（端組-泥明旁轉）}
ning2	neŋ35	䉴{(白)又音}
ning4	neŋ21	凝{凝結，凝固},鬡,薴,聹,甯{通寧字},獰,檸,寧{安寧；寧可，寧願（口語用能願，能字古有寧可義）},宁{同寧字},嚀{叮嚀}
ning6	neŋ22	佞,甯{姓},濘{泥濘},泞,擰{擰轉；倔強}
nip1	nip5	埝{(文)},𠱃{(文)}
nip6	nip2	囁{囁嚅},𦛠,顳,隉,闑,鑷{鑷子},鎳,鄴,躡{躡手躡腳},菍,苶{疲倦},臲,臬,聶{姓},糵,涅,櫱,業,捻{用手指夾住，捏},捏{用手指夾住，捏緊，本字捻},嵲,孽,堨{璧間隙}
nit6	nit2	䡾{車載高也；高貌},𦛠{(又)},齧{齧齒},隉{(又)},闑{(又)},臲{(又)},臬{(又)},糵{(又)},涅{(又)},櫱{(又)},捏{(文)},嵲{(又)},孽{(又)},堨{(又)},囓{同齧字},嚙{同齧字}
niu1	niu55	粈{(白)又音}
niu5	niu24	嫋{嫋娜},鳥{鳥類，小鳥},褭,裊{裊繞},蔦,嬲{戲弄},嬝
niu6	niu22	尿{尿牀，撒尿（口語用屙尿）；尿脬},脲,溺{同尿字}
no1	nɔ55	挼{同捼字，搓},臑{(語)肥～～，胖乎乎},捼{搓，又作挼字}
no2	nɔ35	臑{(語)豬臑[nɔ21]～，豬，童語}
no4	nɔ21	儺,挪{挪動；～～撚[nɐn35]撚[nɐn35]，磨磨蹭蹭},娜{婀娜，古讀上聲}
no5	nɔ24	雫{(又)}
no6	nɔ22	喏{嘆詞},糯{糯米},懦
noek6	nœk2	瘧{瘧疾},蹃,謔{戲謔},虐{虐待}
noeng1	nœŋ55	娘{(白)姑娘},孃{(白)阿～，母之妹}
noeng4	nœŋ21	娘{新娘，娘子，老闆娘},孃{爹孃，孃家}
noi6	nɔi22	佴{姓},錼,萘,耐,耏{去頰鬚刑},柰,奈,倷{吳語字，你}
nok6	nɔk2	喏{同諾字},鍩{放射性化學元素},諾,搦{(書)握；持}
nong1	nɔŋ55	䑋{(白)茁壯、壯實、胖},𧟘{(訓)褲～，褲襠，即襠之音轉（端組-泥明旁轉）},襠{(白)褲～，褲襠，端組-泥明旁轉，俗字𧟘},囊{(白)泡[pʰau55]（穮）～肉，囊膪、奶脯肉}
nong4	nɔŋ21	囊{行囊，囊括},饢{一種烤製成的麪餅},穰{(又)同瓤字},瓤{瓜瓤},囔
nong5	nɔŋ24	擃{同攮字},饢{拼命往嘴裏塞食物},曩,攮{用刀攮}
nong6	nɔŋ22	儾{寛緩},𧟘{寛緩也},齉
not1	nɔt5	肭{(白)肥～～，胖乎乎，與腯旁轉}
nu4	nu21	奴,駑,笯,砮{磨刀石},孥
nu5	nu24	努,腦,胬,砮{石箭鏃},瑙,惱,弩,堖
nu6	nu22	怒
nui1	nui55	推{(白)推搡，端組-泥明旁轉，俗字擩},擩{(訓)推搡，即推之音轉（端組-泥明旁轉）}
nui5	nui24	浽{溾浽},餧{同餒字},餒{凍餒，氣餒}
nui6	nui22	內
nuk1	nʊk5	搙{揉搓，～麪粉}
nuk6	nʊk2	傉,衄,朒,恧,忸{忸怩}
nung1	nʊŋ55	儂{(又)},𪒬{焦、煳，俗字燶},鬞{～鬤，窩囊，不整潔},燶{焦、煳，本字𪒬}
nung2	nʊŋ35	捅{(白)捅，端組-泥明旁轉，俗字搑},搑{(訓)捅，即捅之音轉（端組-泥明旁轉）}
nung4	nʊŋ21	儂{儂家},齈{多涕鼻疾},醲,農,膿,穠,濃,噥
nung6	nʊŋ22	弄{玩弄}
nyu2	ny35	女{(白)專指女兒或女孩，崽女，息女（重孫女），姪女，外甥女，友女（後起詞）}
nyu5	ny24	女{女人，婦女},釹
nyun5	nyn24	暖,煖{同暖字}
nyun6	nyn22	嫩
o1	∅ɔ55	喔{嘆詞},阿{阿膠，阿彌陀佛，阿諛；姓},痾,屙{屙屎，屙尿},婀,娿
o2	∅ɔ35	哦{表驚奇},嚄{嘆詞}
o4	∅ɔ21	哦{表應允或醒悟}
oet6	∅œt2	噦{(語)嘔吐聲}
oi1	∅ɔi55	哀,鎄,欸{歎也},娭{娭毑},埃{(文)塵埃}
oi2	∅ɔi35	噯{噯氣；嘆詞，表否定},靉,靄{霧靄},藹{和藹},毐,曖{曖昧，讀同藹/靄},堨{塵埃}
oi3	∅ɔi33	嬡,隘{(又)},璦,愛
ok3	∅ɔk3	噁{噁心},肟{有機化合物的一類，英語oxime音譯},惡{善惡},堊,噁{二噁英}
on1	∅ɔn55	安,鮟,鞍,氨,桉{桉樹}
on2	∅ɔn35	銨
on3	∅ɔn33	咹{聲止},胺{有機化合物的一類},桉{同案字；〈又〉桉樹},案,摁{用手按壓},按
ong1	∅ɔŋ55	肮{同骯字},骯{骯髒}
ong3	∅ɔŋ33	盎
paa1	pʰa55	舥{(又)},趴{趴下，馬趴；〈外〉證件，英語passport，已罕用},葩{(又)}
paa2	pʰa35	扒{(語)牛～，牛排}
paa3	pʰa33	帊,怕
paa4	pʰa21	巴{(語)下～，下頜，又作下扒},鈀{同耙字，釘鈀},耙{犁耙，耙田},筢,琶{琵琶},爬,潖,杷{枇杷},掱,扒{扒手，扒草，扒龍船（劃龍舟）}
paai1	pʰai55	派{(白)～頭；夠～，有派頭}
paai3	pʰai33	㭛{藤屬},蒎,湃{(又)},派{派出所，派別},哌
paai4	pʰai21	俳,𥱼{竹排，又作簰/箄字},簰{同𥱼字},篺,箄{同𥱼字},牌,排
paak1	pʰak5	啪{象聲詞，噼啪}
paak3	pʰak3	岶,𢫦{同拍字},魄{魂魄，氣魄},迫{強迫，迫害，迫擊炮},袙,蘗{(白)},舶{(白)},粕{(白)},珀,泊{(白)湖泊，梁山泊；泊船，停泊},檗{(白)黃檗，又作黃柏},柏{(白)柏樹，松柏},拍{與搒/抨對轉},帛{(又)},帕
paan1	pʰan55	扳{通攀字},攀{高攀，攀登}
paan3	pʰan33	盼,襻{紐襻},袢{同襻字；袷袢}
paan4	pʰan21	爿,𨂝{徒步涉水；爬},踫{同𨂝字}
paang1	pʰaŋ55	㼞{(白)搪瓷或金屬大碗},𨭌{搪瓷或金屬大碗，本字㼞/甏},甏{(白)同㼞字，搪瓷或金屬大碗},牓{(白)門～，門框兩側，貼對聯用},泙{水聲},弸{(語)兩手平伸的距離},亨{(語)臭～～，臭烘烘，疑與脝有關}
paang3	pʰaŋ33	㼞{罌屬}
paang4	pʰaŋ21	嘭{象聲詞},龐{(白)龐大；姓},鵬,蟛{蟛蜞；～鉗，小河蟹},螃{(白)螃蟹},舽{(白)吳船名},膨{膨脹},硼,澎,淜{淜湃},棚{草棚，棚架},搒{笞打},彭
paang5	pʰaŋ24	抨{(白)驅趕，與拍對轉}
paat3	pʰat3	汃{水波相激聲}
paat6	pʰat2	坺{(語)仰～㳐[ɬat2]，跌成四仰八叉；坐～㳐[ɬat2]，像一攤泥似地坐着；睡～㳐[ɬat2]，睡像難看地睡着；疑本字跋躠}
paau1	pʰau55	拋{(文)},雹{(訓)冰雹，訓讀泡},脬{(文)捧～，巴結、拍馬屁},穮{禾虛貌；〈語〉虛鬆不實，俗字泡},泡{量詞；泡打粉；〈語〉虛鬆不實，本字穮}
paau2	pʰau35	跑{(文)}
paau3	pʰau33	奅{(文)},豹{(又)},砲{(文)},皰{(文)},炮{(文)},泡{浸泡；〈又〉泡沫}
paau4	pʰau21	刨{(文)},麅,颮{風聲},鞄,鑤{(文)},鉋{(文)},狍,庖,咆,匏{(文)}
pai1	pʰɐi55	批{批改，批評，批發；抹，～灰，抹灰，～摥，用抹子抹平},𠜱{削，～皮},錍,鈚{鈚箭}
pam1	pʰɐm55	嘣{(語)清脆的迸裂聲}
pam2	pʰɐm35	渢{(語)輕物落水聲}
pam4	pʰɐm21	嘣{(語)沉悶的迸裂聲}
pan1	pʰɐn55	噴{(語)訓斥、罵}
pan2	pʰɐn35	品{出品，品行}
pan3	pʰɐn33	噴{噴水，噴嚏，噴香；手槍的俗稱，現代又指散彈槍},濆{通噴字},湓{水聲},歕{同噴字}
pan4	pʰɐn21	嬪{嬪妃},顰,頻{頻繁},貧,蘋{大萍},玭,瀕
pan5	pʰɐn24	牝
pang1	pʰɐŋ55	亨{同烹字},閛{(又)},砰{(又)},烹{烹飪，烹調},怦{(又)},匉{(又)},伻{(又)}
pang4	pʰɐŋ21	凭{同憑字},鬅{鬅鬙},馮{暴虎馮河；通憑字},朋{朋友},憑{憑據，文憑},弸{弸弓},堋{分水堤壩}
pap1	pʰɐp5	卟{(語)球破聲；摔打聲}
pap6	pʰɐp2	卟{(語)拍衣聲}
pat1	pʰɐt5	匹{一匹布，匹配},𠯔{嘆詞，～斜咧[lɛ21]，呸},苉,疋{同匹字},拂{(白)撣、拂去，～乾淨}
pau2	pʰɐu35	剖,瓿,棓{躡板},掊{擊},婄{女貌；不才}
pau3	pʰɐu33	穮{(白)鬆，俗字婄/䋨}
pau4	pʰɐu21	垺{盛大},裒,掊{聚斂},抔
pe1	pʰɛ55	披{(語)挨～凳，靠背椅；竹～，長條竹片},𠵿{(外)撲克，打～，打撲克，英語pair}
pek3	pʰɛk3	劈{劈開；～酒，豪飲}
pen1	pʰɛn55	篇{(白)罕讀},翻{(白)～草，～書}
pen2	pʰɛn35	片{(白)〈動〉片肉；〈名〉尿片，打水片（打水漂兒）}
peng1	pʰɛŋ55	呯{(語)～～，鐵瓶蓋或小鐵盒，或爲象聲},拼{(白)靠板，牀～，牀兩頭的靠板，高/低～，牀頭/尾的拼板}
peng4	pʰɛŋ21	呯{(白)打銅鑼聲},平{(白)便宜}
peng5	pʰɛŋ24	並{(白)～骨，肋骨，俗字𩩍},𩩍{(語)～骨，肋骨，本字並}
pet1	pʰɛt5	𩖼{(語)打手～，打手掌}
pet6	pʰɛt2	𩖼{(語)～一槍，打一槍}
peu1	pʰɛu55	拋{(白)拋開，拋棄},脬{(白)尿脬，卵脬；捧～，巴結、拍馬屁},泡{(白)量詞；泡打粉}
peu2	pʰɛu35	掊{(白)清除},跑{(白)跑步}
peu3	pʰɛu33	奅{(白)虛大；車大～，吹牛},豹{(又)},砲{(白)},皰{(白)},炮{(白)槍炮，炮仗},泡{(白)起泡，水泡，氣泡}
peu4	pʰɛu21	刨{(白)削也；刨刀},鑤{(白)},鉋{(白)},稃{(白)～穀，秕穀},匏{(白)}
pi1	pʰi55	㓟,駓,鎞{箭鏃},鈹{大針；長矛},苤,胚{(常)胚胎},紕{紕漏；〈語〉布類表面有毛刺},砒,狓,狉,披{披掛},帔{古代戲服},坯{(常)土坯},坏{(又)},呸,伾,丕
pi2	pʰi35	仳,鄙,痞{痞子，地痞},彼{彼此},庀,圮,嚭,否{否極泰來},吡{詆毀},佊{不正}
pi3	pʰi33	媲{媲美},譬{譬如，譬喻},濞,淠{淠河},帔{霞帔},屁,嬖
pi4	pʰi21	埤{埤益},鼙,鮍,陴,陂{地名，黃陂（在湖北）},鈹{金屬元素，符號Be},鈚{犁錧別名},郫,邳,貔,裨{裨將},蠯,螷,蜱,蚍,芘{芘芣},膍,脾,紕{飾緣邊也},皮,疲,琵{琵琶},毘,毗,椑{椑榼},枇{枇杷}
pi5	pʰi24	婢{(又)},被{棉被，植被},睥{(又)}
pik1	pʰek5	僻,鷿,霹,闢{開闢，精闢},釽,辟{復辟，辟邪},癖,甓,澼,擗,揊{擊聲},噼{象聲詞，噼啪}
pin1	pʰin55	偏,蹁,蝙,翩,編{編寫，郵編},篇{篇章，詩篇},犏,煸,扁{扁舟；扁桃樹/果，又作偏字}
pin3	pʰin33	片{一片，藥片},騙{騙馬；欺騙},遍{一遍，遍地}
pin4	pʰin21	㛹,𡎚,骿,駢,蹁{(又)},諞{巧言},褊{褊褼},胼,緶{用針縫},楩,便{便宜，大腹便便}
pin5	pʰin24	諞{誇耀}
ping1	pʰeŋ55	伻,閛,砰,砯,甹,淜{淜滂},涄,抨{抨擊},怦,娉{娉婷},匉,俜
ping3	pʰeŋ33	姘{姘頭，讀同拼},聘,拼{拼湊，拼合；拼命，打拼},娉{同聘字，定婚}
ping4	pʰeŋ21	伻{(又)},𩩍{肋骨},鮃,鉼{古地名},評,蚲,蘋{蘋果},蓱,萍,荓,苹{藾蕭，即艾蒿},缾,瓶,玶,洴,泙{水名},枰,抨{(又)},平{和平，平坦},帡,屏{屏風},塀,坪,呯{象聲詞}
pit3	pʰit3	䥕,瞥,氕,撇{撇捺；撇開}
piu1	pʰiu55	嘌{疾速},飄,螵,縹{縹緲},漂{漂浮},摽{擊}
piu2	pʰiu35	瞟,縹{青白色；青白色絹}
piu3	pʰiu33	嘌{嘌呤},鰾{魚鰾，讀同漂},驃{驃勇},票{車票},漂{漂白；漂亮}
piu4	pʰiu21	剽,薸,瓢{水瓢},朴{姓},嫖{嫖賭；嫖字分音作皮條}
piu5	pʰiu24	慓,莩{同殍字},殍,摽{落下；緊捆綁}
po1	pʰɔ55	坡,頗{(又)},陂{陂陀},樖{(量)粵字，棵、株，本字科},棵{(訓)量詞，本字科，俗字樖}
po2	pʰɔ35	叵,頗{頗有，偏頗},鉕,笸{笸籮（口語用㬍籮）}
po3	pʰɔ33	破,簸{(又)動詞，～米，～穀}
po4	pʰɔ21	婆{婆婆[pʰɔ35]（外祖母），老婆（妻子）},鄱,菩{(習)菩薩，菩提},繁{姓},皤
pok3	pʰɔk3	帛{(常)玉帛，布帛},釙,蒪{蒪苴},粕{(文)},猼{同蒪字},烞,朴{朴樹；朴刀；〈語〉布～，用碎布拼成的鞋底原料，打布～，用布料補鞋底}
pong1	pʰɔŋ55	胮{腫},𩐨{鼓聲},膀{膀腫}
pong3	pʰɔŋ33	肨{腫脹},胖{(又)肥胖，本字肨}
pong4	pʰɔŋ21	傍{傍晚},𩐨{(又)},龐{(文)},鰟{鰟鮍},雱,逄,螃{(文)},蒡{隱荵},舽{(文)},膀{膀胱},磅{磅礡},滂{滂沱},旁{旁邊，兩旁},房{阿房宮},徬,彷{彷徨}
pong5	pʰɔŋ24	棒{(又)},蚌{蚌殼，河蚌；蚌埠市},耪,棓{(又)}
pu1	pʰu55	潽{液體沸騰溢出},鋪{鋪設},舖{同鋪字}
pu2	pʰu35	哺{哺育},黼,鐠,輔{輔助，輔導},譜,脯{果脯},甫{杜甫，台甫，驚魂甫定},潽{水名},溥,浦,氆,普,捕{逮捕，捕捉},埔{柬埔寨},圃
pu3	pʰu33	舖{同鋪字},鋪{店鋪}
pu4	pʰu21	匍,酺,袍,袌{同袍字},蒲{菖蒲，蒲公英},蒱,葡,菩{(書)},莆{莆田；姓},脯{胸脯},瓠{(語)瓠瓜，同蒲瓜，蒲實爲浮},浮{(白)浮頭，浮薸}
pu5	pʰu24	婦{(白)心抱，本字新婦，前字受後字逆同化},袌{同抱字},泡{泡沫},抱
pui1	pʰui55	坏{同坯字},醅,衃{瘀血},胚{胚胎},垺{製陶模型；大},坯{土坯}
pui3	pʰui33	佩{佩服，玉佩},霈,配,茇{白色的凌霄花},琲,珮{同佩字，玉珮},沛,旆
pui4	pʰui21	培,陪,錇{化學元素},賠,裴,徘
pui5	pʰui24	倍,蓓,碚,棓{五棓子}
puk1	pʰʊk5	仆{仆倒},醭{醋生白醭},瞨,璞,樸{樸素，純樸},攴,撲{撲滅，反撲},扑,墣,噗,卟{卟吩},卜{占卜，卜卦},僕{(又)}
puk6	pʰʊk2	僕{僕人}
pun1	pʰun55	潘{姓},番{番禺}
pun3	pʰun33	判,泮{泮宮，入泮},拚{拚命；～爛，耍賴},叛{背叛，叛徒}
pun4	pʰun21	柈{同槃/盤字},蹣{蹣跚},蟠,胖{心廣體胖},磻{磻溪},磐,盤,盆,湓{水涌；水名},槃
pun5	pʰun24	伴{(白)作伴，有伴},胖{肥胖}
pung1	pʰʊŋ55	塳{(白)灰塵大},髼{(白)～鬆，又作蓬鬆/鬔鬆；～頭～腦，披頭散髮，又作蓬字},逢{(白)撲，狗～人，與撲對轉},蓬{(白)～鬆，又作髼鬆/鬔鬆；～頭～腦，披頭散髮，又作髼字；白～～，雪白，俗字塳}
pung2	pʰʊŋ35	捧{捧場，吹捧}
pung3	pʰʊŋ33	掽{同碰字},踫{同碰字},碰,椪
pung4	pʰʊŋ21	塳{塵也},髼{髮亂},韸{鼓聲},逢{鼓聲；姓},蓬{蓬勃，蓬鬆；〈語〉～腫，腫脹},芃,篷
put3	pʰut3	撥{(白)搧，～扇，搧扇子},鏺,醱{再釀酒},潑{潑水，活潑}
saa1	ʃa55	㸺,鯊,裟,莎{莎士比亞},紗,砂,痧,沙{泥沙，沙漠；〈語〉～洲（州），好打扮、愛露臉，～脤，愛炫耀},挲{挓挲},唦{象聲詞；元曲中的語氣詞}
saa2	ʃa35	啥,耍{戲耍，耍把戲；〈語〉玩，去～，去玩，講～笑，開玩笑}
saa3	ʃa33	嗄{聲音嘶啞}
saa4	ʃa21	唦{(語)～～滾，輕率亂來、亂哄哄；～哩[li55]躘[lʊŋ22]蹱[tʃʰʊŋ33]，莽撞；量詞，一～雨，一陣雨}
saai2	ʃai35	廈{旁屋},甩{甩手；扔；本字摋},摋{抖擻}
saai3	ʃai33	晒{同曬字},殺{減削也；衰也},曬
saai5	ʃai24	舐{舐犢},𤿂{白～～，雪白，本字不明}
saai6	ʃai22	摔{(又)摔倒，摔跤}
saak3	ʃak3	愬{驚懼貌},索{(白)量詞，邊、塊、片，兩～，兩片，～角，邊角，肋～骨，肋骨，俗字𤖴/析/𢱢},粣{糝也},溹{溹溹},洓,槭{葉落貌},摵{捎；同槭字；〈語〉～飯，指菜開胃，下飯},拺{擇}
saam1	ʃam55	摻{摻摻},釤{金屬元素，符號Sm；姓},衫,芟,穇{稴穇}
saam3	ʃam33	釤{釤鐮，釤草}
saan1	ʃan55	刪,閂{門閂，閂門},跚,訕{(語)～嗖[ʃɐu33]，髒話，已罕用，又作訕嗽},舢{舢舨，舢板},膻{(又)},羶{(又)},珊,潸,栓,柵{柵極},杣,拴,山,姍
saan3	ʃan33	汕,訕{訕笑，搭訕},疝{疝氣},涮{涮洗}
saan4	ʃan21	僝{憂愁},潺,漦{(白)唾液},孱{孱弱}
saang1	ʃaŋ55	牲,胜{餼肉；胜鍵},笙,甥{外甥，外甥女},生{生活，學生；～成，本就、本來}
saang2	ʃaŋ35	㗂,眚,省{節省，省份},㨘{擦拭；訓斥；打；一說本字㼽/搡}
saang3	ʃaŋ33	鋥{(又)黃～～，黃澄澄}
saap3	ʃap3	㵤{(白)～氣，傷腦筋，俗字霎},霎{(語)～氣，傷腦筋，本字㵤}
saap6	ʃap2	煠{(文)}
saat3	ʃat3	刷{刷白},鎩,脎,煞{惡煞，煞尾，煞費苦心},殺{殺敵，謀殺},摋{雜糅},剎{同刹字，剎車，剎那，古剎},刹{刹車，刹那，古刹}
saat6	ʃat2	䶡{咬物聲}
saau1	ʃau55	捎{捎帶},鞘{鞭鞘},蛸{蠨蛸},艄,筲{筲箕},稍{(又)},梢{樹梢}
saau2	ʃau35	稍{稍後，稍微（口語用稍爲）}
saau3	ʃau33	哨{哨兵，放哨，口哨；牙～～，齙牙貌},睄{小視},潲{(文)}
saau4	ʃau21	睄{(語)掃視}
sai1	ʃɐi55	篩{篩子，篩選},簁
sai2	ʃɐi35	使{(習)使用；大使},駛,史{(習)歷史}
sai3	ʃɐi33	世,貰,笹,勢{勢力，形勢；手～，手藝、廚藝}
sai6	ʃɐi22	噬{吞噬，反噬},逝,誓,筮,澨,柿{柿子，柿餅；部分老派有讀[tʃʰi21/tsʰɿ21]音}
sam1	ʃɐm55	參{人參},鰺,郴,蔘,綝,琛,深,棽{(又)},森
sam2	ʃɐm35	嬸,邥,讅,諗{諗知，諗悉},瞫,瀋{瀋陽市},沈{姓},審
sam3	ʃɐm33	沁{沁人心脾},瞫{(語)偷看；細看},瘮,滲{(文)}
sam4	ʃɐm21	忱,諶{信也；誠也；姓},煁
sam6	ʃɐm22	什{什麼，同甚麼},葚{桑葚},甚{甚至；甚麼},椹{同葚字}
san1	ʃɐn55	伸{延伸},身{全身；古地名，身毒},紳,神{神荼},砷,申,珅,呻{呻吟}
san3	ʃɐn33	呻{(語)訴苦，～窮，哭窮},瞬
san4	ʃɐn21	䢅,馴{馴養，馴服},錞{錞于，古樂器},鉮,醇{酒味醇},辰,蓴{蓴菜},蒓{蒓菜},脣{口脣，脣齒},純{純粹，單純},神{精神，神聖},淳,殉,榊,晨,徇,宸,娠,唇{同脣字},侚
san5	ʃɐn24	脤{生肉；（芋頭等）脆而不麪；（人）不機靈，～崽},蜃,腎
san6	ʃɐn22	愼,順,舜,胂{有機化合物的一類},慎
sap1	ʃɐp5	溼{潮溼，溼潤},鈒{戟},譅,濕{同溼字},澀{羞澀；〈又〉苦澀}
sap6	ʃɐp2	什{什錦，什物},辻,拾{拾取},十{十足，十全十美}
sat1	ʃɐt5	失{失去，丟失；忔[ŋɐt5]～，吝嗇},鯴,蝨{跳蝨（口語用狗蝨），蝨子（口語用蝨乸）},虱{同蝨字},室
sat6	ʃɐt2	實{真實，老實},鉥,述,術,秫,沭,朮{(常)讀同術}
sau1	ʃɐu55	嗖{象聲詞},溲,收,廋
sau2	ʃɐu35	守{守衛；太守，古讀去聲},首{首先；自首},艏,手
sau3	ʃɐu33	嗖{(語)訕[ʃan55]～，髒話，已罕用，又作訕嗽},瘦,獸,狩
sau6	ʃɐu22	受,綬,授,壽,售
se1	ʃɛ55	奢{奢侈},賒,畲{畲族},畬{燒草耕田；畬族，今作畲；姓}
se2	ʃɛ35	捨{捨棄，捨得},舍{同捨字}
se3	ʃɛ33	厙,騇{母馬},赦,舍{宿舍，校舍，隔籬鄰舍},猞
se4	ʃɛ21	佘{姓},闍{闍黎},蛇{毒蛇},虵{同蛇字}
se5	ʃɛ24	社,舍{(又)宿舍，隔籬鄰舍}
se6	ʃɛ22	射{射箭},麝{麝香}
sek6	ʃɛk2	炻,鼫,祏,碩,石{石頭，岩石；十斗，不從官話之訓讀擔去聲}
sen1	ʃɛn55	挻{(白)掀}
seng1	ʃɛŋ55	聲{(白)}
seng4	ʃɛŋ21	城{(白)省城，出城},成{(白)成日（成天），冇成（不成），成班人（一班人）}
sep6	ʃɛp2	煠{(白)用水熬煮}
set1	ʃɛt5	失{(白)忔[ŋɛt5]～，吝嗇}
set6	ʃɛt2	實{(白)白～～，慘白}
seu3	ʃɛu33	哨{(白)～牙，齙牙},潲{(白)豬潲；潲雨}
si1	ʃi55	㟃,鼶,鸍,鷥,鶳{鳥名；大雀名},鳾{同鶳字},鳲,鰤,餏{量詞，食衣切},颸,鍶,釃,邿,詩{唐詩，詩詞},襹,褷,蟴,螄,蜤{蜤螽},虒,蕬,蓍,葹,罳,緦,絲,絁{粗綢},糸{同絲字},私{自私，私心，家私（家具）},禠,禗,磃{磃氏},獅,澌{澌盡},溮,榹,楒,施,斯,撕{撕開，撕破},恖,思{思念；意思，古讀去聲},廝,師,屍{屍骨，死屍},尸{尸位素餐},噝,嘶{嘶鳴，嘶叫，古讀先稽切},司,厶{私的古字；部首},凘,偲{偲偲},俬{傢俬，同家私（家具）}
si2	ʃi35	使{(書)使用},豕{(又)},矢{通屎字},屎{屎尿；差勁，水平低},史{(書)}
si3	ʃi33	使{(書)大使},駟,謚{同諡字},諡{諡號},試,蕼,肆{放肆},肂,泗,柶,弒{同弑字},弑{弑君，篡弑},嗜,僿
si4	ʃi21	匙{鎖匙，鑰匙},鼭,鰣{鰣魚},蒔{蒔蘿},榯,時,姼{姼母也；美女},塒
si5	ʃi24	市{菜市，市場},鈰
si6	ʃi22	䏡,𩛌{嗜食},豉{豆豉；豉油，易受後字調類化爲陽平},諟,視,褆{衣服端正貌},蒔{蒔秧},祀{祭祀},示,涘,氏{姓氏，氏族},是,戺,忯{恃也},徥,市{(語)利～，紅包},巳{辰巳},峙{繁峙縣},媞{諦也},士,俟{俟機},侍{服侍，侍衛},仕,事
sik1	ʃek5	嗇{吝嗇},骰{(訓)訓讀色；坊間戲稱骰王爲骰魔},飾,銫,適,适{同適字},軾,識{知識，識別},襫,螫,色{顏色，色澤（口語用色水）；色子（骰子）},穡,栻,拭,式,奭
sik6	ʃek2	喰{(又)},食{糧食，食物},蝕{腐蝕，日蝕}
sim1	ʃim55	苫{(名)苫布}
sim2	ʃim35	䀹,陝{陝西},閃,睒,晱
sim3	ʃim33	掞{舒展},苫{(動)遮蓋}
sim4	ʃim21	單{單于},闡{(又)讀同禪},蟾{蟾酥，蟾蜍（口語用蠄蟝）},蟬,禪{禪宗，禪師},嬋
sim6	ʃim22	剡{剡溪},贍
sin1	ʃin55	埏{揉和},膻{膻味},羶{羶味},烻{光},搧{搧耳光，搧人；〈又〉搧動},挻{柔也；取也}
sin2	ʃin35	鱔{(又)黃鱔}
sin3	ʃin33	䥇,騸{騸馬，騸狗},釤{(又)釤鐮，釤草，又作䥇字},煽{煽動，煽風點火},搧{搧動，搧風，搧扇子；〈語〉甩、滑倒},扇{扇子，風扇，一扇}
sin4	ʃin21	澶{澶淵}
sin5	ʃin24	鱔{鱔魚，黃鱔，白鱔}
sin6	ʃin22	倩{倩影，倩裝；請，古讀七政切},饍{同膳字},鄯,蟺{蟺蜎，蜿蟺},蟮{蛐蟮},蒨,茜{茜草},膳{膳食，藥膳},繕,綪{赤繒；青赤色},箐{竹木叢生的山谷},禪{禪讓，禪位，俗讀禪宗之禪},擅,撣{撣族},嬗,墡,墠,單{姓},善
sing1	ʃeŋ55	升{升級，上升，一升},陞{姓},聲{(文)},枡,昇{畢昇；旭日東昇},抍,塍{(又)}
sing3	ʃeŋ33	勝{勝利；勝任，古讀平聲；方～，便條，通～，皇曆、曆書，避諱輸},蟶{(又)},胜{同勝字},聖,圣{同聖字}
sing4	ʃeŋ21	丞,鋮,郕,誠,繩,盛{盛滿},珹,澠{古水名},椉{同乘字},晟,承,成{完成，成功},宬,塍{田塍},城{城市，城門},乘{乘坐}
sing6	ʃeŋ22	乘{千乘},盛{旺盛；姓},椉{同乘字},嵊,剩{(書)}
sip3	ʃip3	䀹{(又)},灄,涉,歙{地名，歙縣（在安徽）},攝,懾
sit6	ʃit2	折{折本，折底（吃虧）},鞨{治革},蝕{蝕本，同折本},舌,揲{揲蓍}
siu1	ʃiu55	燒
siu2	ʃiu35	少{多少}
siu3	ʃiu33	少{少年}
siu4	ʃiu21	柖,韶{韶華，韶光},苕{紅苕},玿
siu6	ʃiu22	劭,鮡{(又)},邵,肇,紹,召{姓；周朝國名}
slaa1	ɬa55	卅{三十，三啊[a22]的合音，啊[a22]爲十的弱讀}
slaa2	ɬa35	洒{同灑字},灑{灑水}
slaa4	ɬa21	𩄝{(語)詞綴，落雨～～，雨淅瀝貌}
slaai1	ɬai55	㩄{浪費，俗字嘥},諰{～譡[tɔŋ33]，奚落諷刺人},嘥{浪費，本字㩄}
slaai3	ɬai33	哂{(語)同嗮字},嗮{粵字，本地表完全、全部或完成，可作全稱量詞（範圍副詞）、完成體標記（了1）、已然體標記（了2）、完結義動詞、程度副詞、結果補語和連詞，一說本字澌/㩄/煞/殺，又作哂字；表全稱、程度和結果時，現在多用齊}
slaak1	ɬak5	㩇{(語)裂開、折斷，～開邊[pɛn55]，剖成兩半}
slaam1	ɬam55	三{三個；三思，古讀去聲；～點頭、～點、～星公，猜碼口令，數字三，猜碼時讀高降調},毿,弎,叄,叁,仨
slaam2	ɬam35	糝{(又)}
slaam4	ɬam21	饞{(白)又音，餓～～，餓貌}
slaan2	ɬan35	傘{(又)},饊{米花糰},糤{同饊字},散{鬆散，散彈槍；～紙/錢，零錢}
slaan3	ɬan33	傘,鏾{弩},潵{水散也},散{解散，分散}
slaap1	ɬap5	𠿓{(語)猛咬（一口）}
slaap3	ɬap3	㵤{溢也},𥈊{理睬，搭～，搭理},𢶍{擸𢶍，又作垃圾},𠿓{醜；食貌，～得，食慾好},馺{馬行疾},颯{颯颯，颯爽},靸{小兒履；靸鞋},霎{霎時，一霎那；～黑，黃昏；～眼，轉眼},霅{雨雹下貌},鎝{鏤},鈒{鈒鏤},趿{進足},歃{歃血},圾{垃圾，本字擸𢶍},喢{多言；～戇[ŋɔŋ33]，傻瓜、言行無道理},唼{唼喋}
slaat3	ɬat3	摋{側手擊},躠{跋躠},薩{菩薩，拉薩；姓},潵{潵河},攃{象聲詞；同撒字},撒{撒手，撒種}
slaat6	ɬat2	㳐{(語)仰坺[pʰat2]～，跌成四仰八叉；坐坺[pʰat2]～，像一攤泥似地坐着；睡坺[pʰat2]～，睡像難看地睡着；疑本字跋躠}
slaau4	ɬau21	捎{(語)吃；揍}
slai1	ɬɐi55	恓,西,荽{(習)芫荽，又作芫茜/鹽西},茜{芫茜，茜茜公主},舾,粞,硒,犀,樨
slai2	ɬɐi35	屣{鞋；〈語〉踢、打},躧,蹝{同屣字},諰{恐懼},襹{(又)},褷{(又)},蓰,葸,縰,璽,洗,洒{同洗字},枲,徙
slai3	ɬɐi33	壻{女壻，夫壻},細,婿{同壻字}
slai4	ɬɐi21	屣{(語)揍、打}
slak1	ɬɐk5	噻{噻吩，噻唑；〈語〉大約、數量少、某、任何，～時，有時，本字息，上古職部},揌{通塞字},息{(白)～崽，重孫子，～女[ny35]，重孫女，上古職部；大約、數量少、某、任何，～時，有時，俗字噻},塞{塞車，堵塞}
slak6	ɬɐk2	噻{(語)形容詞後綴，醒～，精神，默～，死亡}
slam1	ɬɐm55	心,芯
slam2	ɬɐm35	伈,糝{撒；粉末}
slam4	ɬɐm21	尋{(白)傻；盲～～，盲目亂來}
slan1	ɬɐn55	侁,駪,鋅,辛,詵,薪,莘,甡,燊,新,屾,噺
slan2	ɬɐn35	栒{栒虡},隼{(又)},筍,笋{同筍字},榫{榫頭}
slan3	ɬɐn33	信,遜,迅,訊,蕈{香蕈，俗作香信},濬{濬河，濬縣},浚{浚河，浚縣},汛,巽,峻{(白)又音，璺[mɐn33]～，邊緣；勉強},囟,噀
slan4	ɬɐn21	侚{(又)},馴{(又)},錞{(又)},醇{(又)},郇{周朝國名},詢,蓴{(又)},蒓{(又)},荀,純{(又)},紃{(又)},珣,淳{(又)},洵,殉{(又)},栒{木名},旬{(又)},揗{(又)},恂{恐懼貌；〈語〉發抖},循{(又)},徇{(又)},巡{(又)},峋
slang1	ɬɐŋ55	鬙{(語)倰[lɐŋ21]～，不整潔}
slang3	ɬɐŋ33	擤{擤鼻涕}
slang4	ɬɐŋ21	㗂{(語)詞綴，毛～～，毛茸茸，高～～，高貌，本字層},層{(白)詞綴，毛～～，毛茸茸，高～～，高貌，俗字㗂}
slap1	ɬɐp5	㿇{小痛},𢶍{(白)～碎，瑣碎、零碎},圾{(白)～碎，瑣碎、零碎，本字𢶍}
slap6	ɬɐp2	喋{(語)詞綴，亂～～，雜亂貌，拜～～，虔誠地拜，白～～，雪白},霫{(白)詞綴，落雨～～，下雨貌，溼～～，溼淋淋，俗字霅},霅{(語)詞綴，落雨～～，下雨貌，溼～～，溼淋淋，本字霫},趿{(語)詞綴，拖～～，拖着鞋走，跟～～，跟隨貌，行～～，疾走貌}
slat1	ɬɐt5	卹{撫卹},銊,裇{英語shirt的音譯，現多用恤字},蟋{(白)～蟀[tʃɐt5]，又作蟋蜶},蟀,蜶,膝,窸,窣,璱,瑟{琴瑟，瑟縮},率{率領},摔{摔手，摔倒，摔跤},戌,悉{熟悉，悉心},恤{體恤}
slat6	ɬɐt2	朮{(又)},鉥{(又)},述{(又)},術{(又)},秫{(又)},沭{(又)}
slau1	ɬɐu55	䗛,饈,餿{飯餿，餿水},颾{同颼字},颼,蒐{蒐集，蒐羅},脩,羞,修
slau2	ɬɐu35	叟,鎪,謏{謏訹},螋,藪,艘,瞍,滫,擻{抖擻},搜{搜查，搜索},嗾{嗾使}
slau3	ɬɐu33	嗽{咳嗽},鏽{鐵鏽，不鏽鋼},銹{同鏽字},繡,綉,秀,琇,宿{星宿，舊讀住宿之宿}
sle1	ɬɛ55	些
sle2	ɬɛ35	寫,瀉{(白)倒～，溢出、打潑}
sle3	ɬɛ33	卌{四十，四啊[a22]的合音，啊[a22]爲十的弱讀},瀉{傾瀉，瀉藥},卸
sle4	ɬɛ21	斜{(白)乜[mɛ21]～，醉態}
slek3	ɬɛk3	惜{(白)儆[kɛŋ22]～，珍惜；疼愛},錫
slem4	ɬɛm21	饞{(白)餓～～，餓貌}
slen3	ɬɛn33	峻{(白)璺[mɛn33]～，邊緣；勉強}
slen4	ɬɛn21	恂{(白)發抖}
sleng1	ɬɛŋ55	星{(白)天星},腥{(白)腥臭，魚腥草}
sleng2	ɬɛŋ35	醒{(白)清醒，睡醒}
sleng3	ɬɛŋ33	鉎{(白)鐵鏽，又作鍟字},鍟{(白)同鉎字，鐵鏽}
slep1	ɬɛp5	㿇{(語)辣痛}
slep3	ɬɛp3	𤗈{(白)楔}
slep6	ɬɛp2	喋{(語)又音},霫{(白)又音},霅{(語)又音},趿{(語)又音}
slet1	ɬɛt5	攃{(語)撕布聲}
sleu1	ɬɛu55	筲{(白)}
sli1	ɬi55	澌{(語)陰～～，天氣或人性格陰沉}
sli2	ɬi35	死
sli3	ɬi33	四{第四，四海；～紅中、～紅四、～紅，猜碼口令，數字四},肆{四字的大寫}
slik1	ɬek5	媳,釋,蟋,螅,蜥,蜤{蜤蜴，即蜥蝪},菥,舄,腊{乾肉},窸{(又)},皙{白皙，皙皙},熄,潟,淅,棤,析,晰,昔,惜{可惜},悉{(又)},息{休息，息怒；滴～，小巧}
slik3	ɬek3	裼{袒裼}
slin1	ɬin55	䙲{同䙴字},鮮{新鮮；鮮卑},酰,躚{(又)},褼,秈,氙,先{先後，祖先；～～，早先、最初；〈語〉（稱物時）秤尾高，本字䙴},僊{同仙字},仙,䙴{升高也；（稱物時）秤尾高，～啲，升高點，俗字先}
slin2	ɬin35	冼,鮮{鮮少；朝鮮，古讀平聲},銑,跣,蘚,筅,禒,癬{腳癬，皮癬},獮,燹
slin3	ɬin33	綫{同線字},騸{(訓)訓讀鏾，～雞，閹雞（名詞）},霰{雨霰，雪霰；霰彈（口語用散彈）},鏾{～雞，閹雞（名詞）},腺,羨,羡,線{針線，線條}
sling1	ɬeŋ55	惺,騂,腥{(文)},瑆,猩,煋,星{流星}
sling2	ɬeŋ35	省{反省，省悟},醒{醒目}
sling3	ɬeŋ33	姓,鍟{(文)},鉎{(文)},性
slip3	ɬip3	躞,𤗈{(文)}
slit3	ɬit3	偰,𤫉,躠{蹩躠},褻,薛{姓},紲,燮,渫{除去；泄；姓},洩{同泄字},泄{泄漏，發泄},榍,楔{楔子},揳{塞},屑{不屑；木屑},媟,契{商之祖}
sliu1	ɬiu55	㩋{把},魈,霄,銷,逍,蠨,蛸{螵蛸},蕭,肖{姓，蕭字俗寫},翛,綃,簫,箾{箾韶},硝,瀟,消,梢{(又)},揱{(又)},捎{(又)},悄{(又)},宵
sliu2	ɬiu35	小,謏{謏聞},筱
sliu3	ɬiu33	咲,笑,嘯
slo1	ɬɔ55	唆{囉唆，唆使，教唆},趖{走意},蓑{蓑衣，蓑草},莎{莎草},羧,簑,睃,梭,桫,挲{摩挲},娑{婆娑，摩娑},嗦{哆嗦}
slo2	ɬɔ35	嗩,鎖,縒{鮮絜貌},璅{同瑣字},瑣{瑣碎，繁瑣},所,惢
slo4	ɬɔ21	傻,𩄝{(語)詞綴，碖[lɐn33]～～，紛紛落下貌}
sloek3	ɬœk3	削{削皮，剝削}
sloeng1	ɬœŋ55	儴{儴佯},鸘,驦,驤,霜,鑲,襄,葙,纕,緗,箱,礵,相{互相，相反},瓖,湘,廂,孀
sloeng2	ɬœŋ35	想,鯗{魚乾},鮝{同鯗字}
sloeng3	ɬœŋ33	相{相貌，相片；影～，照相；小～，小氣；能幹、厲害，耍遊戲噉～}
sloi1	ɬɔi55	愢,鰓,顋,腮{腮幫，面腮},揌{擡揌；〈語〉吃的俗稱，～得，能吃，～客，吃客}
slok3	ɬɔk3	塑{(習)塑像，塑料，讀同朔},遡,蒴,索{繩索；求索，古讀山責切、山戟切},箾{以竿擊人；舞者竿},溹{溹河},溯{追溯，讀同朔},泝,槊,朔{朔月，朔方},搠,揱
slong1	ɬɔŋ55	喪{喪事},𦅇,桑,嗓{(常)讀聲符桑}
slong2	ɬɔŋ35	嗓{嗓子，嗓音},顙,磉{柱下石},搡{推搡；〈語〉掙扎}
slong3	ɬɔŋ33	喪{喪失},𦅇{(又)}
slot6	ɬɔt2	銊{(語)扯動繩索聲}
slu1	ɬu55	囌{嚕囌},鰠,鬚{鬍鬚},騷{風騷，騷動},颾{風聲},酥{酥油，酥脆},蘇{紫蘇；姓},臊{臊味，腥臊},繰{同繅字},繅,穌,甦{甦醒},溞,搔
slu2	ɬu35	嫂
slu3	ɬu33	傃,遡{(又)},訴,臊{害臊},膆{同嗉字},素,瘙,漱{漱口},溯{(又)},泝{(又)},掃{掃地；掃把},愬{同訴字},愫,塑{(書)},埽,嗉{嗉囊}
slu4	ɬu21	擻{(白)詞綴，恂[ɬɐn21]～～，發抖貌；～～𩄝[ɬa21]𩄝[ɬa21]，做事拖泥帶水；韻母演變同漱字}
slui1	ɬui55	浽{浽溦（小雨）；〈語〉溾浽（污穢、骯髒），又作渨涹},雖{雖然},葰{廉薑},荽{(書)},綏{綏靖，扶綏縣},睢,眭{姓},濉
slui3	ɬui33	嗉{(語)雞嗉，鳥嗉子},誶,膆{(語)雞膆，鳥膆子},祟,碎,歲
slui6	ɬui22	瑞{(又)},繐{(又)},穗{(又)}
sluk1	ɬʊk5	㩋{擊；擊聲},鷫,驌,餿{(訓)食物過宿，訓讀宿},蹜{(又)},謖{(又)},蓿,肅,縮{(又)讀聲符宿},粟{粟米，罌粟；包～，玉米},宿{住宿，一宿；餿、酸臭，俗字餿；〈又〉星宿，舊讀},夙,僳
sluk6	ɬʊk2	俗{(又)}
slung1	ɬʊŋ55	倯,鬆{放鬆},菘,淞,松{(又)松樹，松子},忪{惺忪},嵩,崧,娀,凇
slung2	ɬʊŋ35	㩳,聳{聳立；〈語〉金～，骨殖罐},竦,慫{慫恿},悚
slung3	ɬʊŋ33	宋,餸{下飯的菜，本字送},送{贈送；〈語〉下飯的菜，俗字餸}
slung4	ɬʊŋ21	㞞{笨、傻，本字倯，轉讀邪母}
slyu1	ɬy55	嬃,鬚{(又)},須{必須},需,雖{(又)語流音變},諝,胥,繻,綏{(常)語流音變},湑{水名}
slyu2	ɬy35	湑{濾酒去渣},醑,糈
slyu3	ɬy33	嗉{(語)又音},膆{(語)又音},緒{(又)},絮
slyun1	ɬyn55	喧{(又)讀同宣},飧,酸{酸味},蓀,痠{痠痛},瑄,猻,狻,渲{(又)讀同宣},揎,愃,悛,宣,孫
slyun2	ɬyn35	損,隼{(又)},選,筍{(老派)},笋{(老派)},癬{(常)腳癬，皮癬},榫{(老派)},栒{(老派)}
slyun3	ɬyn33	信{(老派)},遜{(老派)},迅{(老派)},訊{(老派)},蕈{(老派)},蒜,算,筭,濬{(老派)},渲{渲染},浚{(老派)},汛{(老派)},巽{(老派)},囟{(老派)},噀{(老派)}
slyun4	ɬyn21	䃠,馴{(老派)},鏇{鏇牀},錞{(老派)},醇{(老派)},郇{(老派)},詢{(老派)},蓴{(老派)},蒓{(老派)},荀{(老派)},純{(老派)},紃{(老派)},璿,璇,珣{(老派)},漩,淳{(老派)},洵{(老派)},殉{(老派)},栒{(老派)},暶,旬{(老派)},旋{旋轉；旋風},揗{(老派)},恂{(老派)},循{(老派)},徇{(老派)},巡{(老派)},峋{(老派)},侚{(老派)}
slyut1	ɬyt5	卹{(老派)},𠽌,雪{(語)白～～，雪白},銊{(老派)},裇{(老派)},率{(老派)率領},摔{(老派)},戌{(老派)},恤{(老派)}
slyut3	ɬyt3	薛{(常)姓},鱈,雪{白雪}
slyut6	ɬyt2	朮{(老派)},鉥{(老派)},述{(老派)},術{(老派)},秫{(老派)},沭{(老派)}
so1	ʃɔ55	梳{梳頭},蔬,疏{疏遠，稀疏；註疏，上疏，古讀去聲},疋{足也}
so4	ʃɔ21	趖{(語)滾～～，水沸聲}
soe4	ʃœ21	嗾{(語)唆使、挑撥，又作𡂡字}
soek3	ʃœk3	爍,鑠
soek6	ʃœk2	勺{湯勺，勺子},芍{(又)},杓{杯杓}
soeng1	ʃœŋ55	傷,鸘{(又)},驦{(又)},霜{(又)},雙{一雙；雙生},觴,礵{(又)},熵,瀧{瀧水，瀧岡},湯{浩浩湯湯},殤,孀{(又)},墒,商
soeng2	ʃœŋ35	尚{(白)和尚},賞
soeng4	ʃœŋ21	裳{衣裳}
soeng5	ʃœŋ24	上{動詞，上山},鞝{鞝鞋},緔{緔鞋}
soeng6	ʃœŋ22	上{方位詞，上面},尚{高尚，尚且}
soi1	ʃɔi55	摔{(又)摔倒，摔跤},衰{(又)衰老，衰落，語流音變}
soi3	ʃɔi33	塞{邊塞，塞外},賽{比賽，賽跑}
sok3	ʃɔk3	嗍{吮吸，本字欶},欶{吮吸，～田螺，吸田螺，～粉，吸毒，俗字嗍},數{數見不鮮}
song2	ʃɔŋ35	塽,爽
song3	ʃɔŋ33	𦅇{(語)詞綴，黃～～，黃澄澄}
su2	ʃu35	數{(動)數一數}
su3	ʃu33	數{(名)數目}
su4	ʃu21	嗖{(語)象聲詞，～～聲}
sui1	ʃui55	衰{衰老，衰落；倒黴}
sui2	ʃui35	嶲{同巂字},髓,瀡,水{清水，水平；〈喻〉錢財，三䊆～，三百元，五兜～，五十元，又喻年齡，五十歲},巂{越巂（在四川）}
sui3	ʃui33	帥{元帥，帥氣},説{同說字},說{遊說，說服，俗讀說話之說},税,稅,涚,涗,捝{擦拭},挩{擦拭},帨
sui4	ʃui21	倕,陲,誰,垂{垂直，下垂},圌{圌山}
sui6	ʃui22	䡵,隧{隧道},鐩,邃,遂{順遂},襚,繐{帽繐},穟,穗{穀穗},睡,璲,瑞{祥瑞，瑞雪},燧,旞
suk1	ʃʊk5	倏,蹜,謖,縮{縮短，退縮},淑{(又)},叔,儵
suk6	ʃʊk2	俗{(又)},贖,蜀{蜀國，蜀道},菽,熟{煮熟},淑{賢淑},屬{屬於，家屬},孰,婌,塾
sung4	ʃʊŋ21	鰫{(又)}
sy1	sɿ55	㟃{(老派)},鼶{(老派)},鷥{(老派)},鶳{(老派)},鳾{(老派)},鰤{(老派)},颸{(老派)},鍶{(老派)},釃{(老派)},詩{(老派)讀同師，類推音變},襹{(老派)},褷{(老派)},蟴{(老派)},螄{(老派)},蜤{(老派)},虒{(老派)},蕬{(老派)},罳{(老派)},緦{(老派)},絲{(老派)},糸{(老派)},私{(老派)},禠{(老派)},禗{(老派)},磃{(老派)},獅{(老派)},澌{(老派)},溮{(老派)},榹{(老派)},楒{(老派)},斯{(老派)},撕{(老派)},恖{(老派)},思{(老派)},廝{(老派)},師{(老派)},噝{(老派)},嘶{(老派)},司{(老派)},厶{(老派)},凘{(老派)},偲{(老派)},俬{(老派)}
sy3	sɿ33	柶{(老派)},駟{(老派)},蕼{(老派)},肆{(老派)放肆},肂{(老派)},泗{(老派)}
sy6	sɿ22	事{(老派)},𩛌{(老派)},祀{(老派)},涘{(老派)},戺{(老派)},巳{(老派)},士{(老派)},俟{(老派)},侍{(老派)讀同事，類推音變},仕{(老派)}
syu1	ʃy55	㻬{(又)},鄃,輸{輸贏；運輸},荼{神荼},舒,紓,毹{(又)},樞,樗,書,攄,摴,抒,姝{(又)}
syu2	ʃy35	暑,鼠,黍,癙
syu3	ʃy33	庶,腧,緒{情緒，緒論},戍{戍守},恕
syu4	ʃy21	噓{嘆詞，表制止},陎,蜍{蟾蜍（口語用蠄蟝）},藷{同薯字},薯{番薯，白薯，薯片},糬,殳,殊
syu5	ʃy24	墅{別墅},署{署名，專署},曙
syu6	ʃy22	樹,豎{橫豎，豎琴},澍
syun3	ʃyn33	瞬{(老派)}
syun4	ʃyn21	唇{(老派)},錞{(又)},醇{(又)},蓴{(又)},蒓{(又)},船,舡,脣{(老派)},純{(又)},淳{(又)}
syun5	ʃyn24	吮,雋{雋永},楯{欄杆}
syun6	ʃyn22	腨,順{(老派)},舜{(老派)}
syut3	ʃyt3	說{說話，小說},説{同說字}
taa1	tʰa55	他,鉈{金屬元素，符號Tl},祂,牠,怹{他的敬稱},它,她
taai1	tʰai55	呔{(外)車～，車胎，英語tyre},𧘹{(外)領～，領帶，英語tie，罕用，多數用領帶}
taai3	tʰai33	傣{(又)},鈦,酞,貸{貸款，借貸},肽,泰,汰,汏{同汰字},態,太
taai5	tʰai24	柁{(白)},軚{本字舵},舵{(白)掌舵，俗字舦},舦{舵，本字舵}
taam1	tʰam55	坍{(又)},貪
taam2	tʰam35	菼
taam3	tʰam33	傝{傝儑},撢{同探字},探{探路，試探}
taam4	tʰam21	倓{倓然},鐔{古兵器，似劍而小；姓},錟{長矛},醰,郯,譚,談,覃{覃思；姓},蟫{蠹魚},蕈{植物名},蕁{知母草},罈{酒罈},磹{地名，磹口（在福建）},痰{吐痰，痰盂},燂{燒熱},澹{澹臺，複姓},潭,榃{水塘，本字潭；地名，榃河，榃冷村},曇,惔{火燒},壜,埮{同壜字}
taam5	tʰam24	淡{(白)清淡，鹹淡，淡季}
taan1	tʰan55	嘽{嘽嘽},癱{(又)},灘,攤{擺攤，攤開},坍{坍塌}
taan2	tʰan35	亶{誠信},鉭,袒,癱{癱瘓，面癱},璮,毯,忐,坦
taan3	tʰan33	嘆{嘆息，嘆氣},碳,炭,歎{詠歎，讚歎}
taan4	tʰan21	壇{花壇，論壇},檀,枟,彈{(文)}
taap1	tʰap5	鞳{(語)又音，剪物聲}
taap3	tʰap3	䍇{平底罈子},鰨{鰨目魚},鞳{鏜鞳},闒{闒茸},錔{(名)器物錔頭，筆～，筆帽},褟,漯{古水名},溻{溻溼，溼溻溻},溚{焦油舊稱；古水名},榻{牀榻，榻榻米},搨{搨本，搨印},拓{同搨字，拓本，拓印},塔,塌{倒塌，塌方，塌臺},嚃,嗒{嗒然若失},傝{傝𠎷}
taat3	tʰat3	塌{(又)},鰨{(又)},韃,靸{靸拉},闥,遢{邋遢},達{挑達},躂{踢躂，蹓躂},趿{趿拉},澾,溻{(又)溼溻溻，後字逆同化},榻{(又)榻榻米，後字逆同化},撻{撻伐；蛋撻；～頭，光頭}
tai1	tʰɐi55	梯,鷉,鷈,銻{一種金屬元素，符號Sb；〈語〉金屬鋁，因色近而代稱，～崽，硬幣，～桶，鋁桶}
tai2	tʰɐi35	体,體,睇{看}
tai3	tʰɐi33	剃,髢,裼{載衣之褓},薙,締{(又)},涕{鼻涕},替,屜{抽屜},嚏
tai4	tʰɐi21	啼,鶗,鵜,鯷,騠,題,隄,醍,遆,蹄,踶{蹄},謕,褆{衣厚貌},荑{初生葉貌},緹,綈,禔,磃{磄磃},瑅,提,媞{媞媞},堤{河堤，堤壩},埞{同堤/隄字}
tai5	tʰɐi24	娣
tak1	tʰɐk5	忑,鋱,慝{惡},忒{忒好，忒大}
tam3	tʰɐm33	探{(白)裝入衣袋，又作撢字},𧨾{哄騙，尤指哄孩子，疑本字誩/䐺/憛},撢{(白)同探字，裝入衣袋}
tam4	tʰɐm21	坍{(語)壓；塌下},𧽼{～～轉，團團轉}
tam5	tʰɐm24	凼{同氹字},窞{(白)小水坑，俗字氹/凼},氹{小水坑，本字窞}
tan1	tʰɐn55	吞,飩{餛飩},焞{光明},暾
tan2	tʰɐn35	氽
tan3	tʰɐn33	褪{～後，後退；～車，倒車}
tan4	tʰɐn21	囤{囤積},魨,迍{迍迍；〈語〉來回走動},豚{海豚，河豚；〈語〉肥～～，胖貌},臀{臀部},忳{憂也；亂也；〈語〉發抖，手～腳震},屯{村屯，屯兵},坉{以草裹土築城及填水；田隴}
tang1	tʰɐŋ55	膯{飽；〈語〉膨脹}
tang4	tʰɐŋ21	滕,鰧,驣,騰,謄{謄寫},螣{螣蛇},藤,縢,籐,疼
tap1	tʰɐp5	錔{(動)套上}
tau1	tʰɐu55	偷
tau2	tʰɐu35	㪗{～氣，歇氣，又作敨字},敨{同㪗字，～氣，歇氣},唞{休息，本字㪗/敨}
tau3	tʰɐu33	咅,透{透明；～火，生火，俗字炓},炓{(語)～火，生火，本字透}
tau4	tʰɐu21	投,骰{骰子},頭,酘{酒再釀},牏{(又)}
tek3	tʰɛk3	剔{(白)剔除，剔骨},踢{踢球，猛踢；一腳～，一手包辦}
ten4	tʰɛn21	彈{(白)彈琴，彈手指}
teng1	tʰɛŋ55	听{(白)同聽字},聽{(白)聽見},汀{(白)},廳
teng5	tʰɛŋ24	艇{遊艇；底～，內褲}
tep1	tʰɛp5	鞳{(語)剪物聲}
tet1	tʰɛt5	趿{(白)拖～鞋，拖鞋}
teu2	tʰɛu35	挑{(白)提，～水，提水},掉{(白)倒掉（水）；打～，打潑}
tik1	tʰek5	俶{俶儻，即倜儻},逖,趯{跳貌},擿{挑出；揭露},惕,剔{挑剔，剔牙},倜
tim1	tʰim55	㖭,𠻹,黇,添
tim2	tʰim35	㮇{㮇筆},舔{狗舔},栝{撥火棍；木杖},掭{掭筆，又作㮇字},忝
tim4	tʰim21	恬,菾,甜,湉
tin1	tʰin55	兲,天
tin2	tʰin35	捵{(又)},靦{(又)},覥{(又)},腆{(書)},町{町疃},淟{(又)},晪{(又)}
tin3	tʰin33	捵{(語)掙扎},瑱{玉名；耳飾}
tin4	tʰin21	佃{佃作},鿬,鴫,闐,鈿{錢},窴,畠{日本漢字},畑,畋,田,滇{水流貌},沺,填,嗔{嗔嗔}
tin5	tʰin24	殄
ting1	tʰeŋ55	听{(文)},聽{(文)聽見；〈語〉～日，明日，天光的合音},綎,町{(又)地名，讀同汀},烴{碳氫化合物},汀{(文)},桯{桯子，桯凳},朾{虛朾}
ting2	tʰeŋ35	侹,頲,町{町畦},珽,挺,圢
ting3	tʰeŋ33	听{同聽字},聽{聽候，聽從，俗讀聽見之聽}
ting4	tʰeŋ21	䗴,霆,蜓{蜻蜓},葶,莛,綎{(又)},渟,廷,庭,婷,停,亭
ting5	tʰeŋ24	梃,鋌{鋌而走險},烶
tip3	tʰip3	䑜{小舐},跕{跕屣},貼,萜,帖{碑帖，請帖，妥帖}
tit3	tʰit3	銕{同鐵字},餮,鐵
tiu1	tʰiu55	佻{輕佻},雕{(又)雕刻},祧,挑{挑擔，挑戰},彫{(又)彫刻}
tiu3	tʰiu33	朓,跳{跳高，跳舞；～皮，調皮、頑皮},趒,糶,眺
tiu4	tʰiu21	䯾{髮多},齠,鰷,髫,銚{長矛},迢,調{調和，調整},蜩,苕{凌霄花；苕菜},笤,條,嬥{身材修長而美好},佻{佻佻}
tiu5	tʰiu24	窕
to1	tʰɔ55	拕,拖{拖拉，拖船}
to2	tʰɔ35	妥{(又)},橢{(又)}
to3	tʰɔ33	唾{唾液，唾棄}
to4	tʰɔ21	佗,鼉,鴕,鮀,駝,馱{馱起},陀{陀螺},阤{陂阤},鉈{秤砣},酡,跎{蹉跎},舵{(又)},砣,沱,柁{木葉落；房柁},堶,坨
to5	tʰɔ24	妥{妥當，穩妥},舵{舵手，掌舵},橢{橢圓},柁{同舵字}
toe3	tʰœ33	唾{(白)～口水，吐口水}
toi1	tʰɔi55	胎{胎兒，懷胎},苔{舌苔}
toi2	tʰɔi35	㘆{語不正},呔{語不正，本字㘆}
toi4	tʰɔi21	儓,鮐,駘{劣馬},颱{颱風},邰,跆,薹{蒜薹},苔{青苔},臺{平臺，臺階},炱,檯{櫃檯，檯面},枱{同檯字},擡{擡頭，擡高},抬{同擡字},台{兄台；台州，天台山}
tok3	tʰɔk3	侂,魄{落魄，又作落拓},飥,託{委託，託付},蘀,籜,橐,柝,拓{開拓，拓展},托{托起，烘托},庹
tong1	tʰɔŋ55	劏{宰殺，本字湯；路名，劏羊街，即今當陽街},鐋{鐋鑼},鏜{象聲詞，鏜鞳},蹚,羰,湯{雞湯，湯圓；宰殺，俗字劏},嘡
tong2	tʰɔŋ35	倘{倘使},钂,鎲,躺,耥{耥耙},淌,惝{(又)},帑,儻
tong3	tʰɔŋ33	摥{推，～櫳門，推式房門，批～，用抹子抹平},鐋{平木石器；熱酒},趟{一趟},燙,熨{(訓)熨斗，訓讀燙}
tong4	tʰɔŋ21	䣘,餳{同餹字},鏜{加工零件之法},醣,鄌,螳{螳螂（口語用馬螂扛）},螗,茼{(語)茼蒿，又作塘蒿},膛,糖,瑭,溏,樘,棠,搪,塘,堂,坣,唐
tu1	tʰu55	㻬,饕,韜,縚,絛,滔,搯{掏，挖取},挑{挑達},慆,弢,叨{叨光}
tu2	tʰu35	土,釷,討
tu3	tʰu33	兔,菟{菟絲},套,堍,吐{吐痰；嘔吐}
tu4	tʰu21	匋,鼗,騊,駼,鞀,陶{陶冶，陶器},酴,途,逃,萄,菟{於菟},荼{荼毒，如火如荼},綯{拴；綁},稌,瘏,燾{人名用字},濤,淘{淘米，淘氣},涂{姓；通塗/途字},洮{盥洗},檮,梌,桃,掏{掏錢},徒,屠,塗{泥塗，塗抹},圖,啕,咷
tu5	tʰu24	肚{豬肚；肚皮}
tui1	tʰui55	推{推開，推動},焞{盛}
tui2	tʰui35	腿
tui3	tʰui33	煺,退,褪{褪色},蜕,蛻
tui4	tʰui21	穨,魋{獸名},頽,頹{頹廢；〈語〉蠢笨},隤
tuk1	tʰʊk5	禿{禿頂，光禿禿},𢬳
tung1	tʰʊŋ55	嗵,通,熥,恫{恫瘝},彤{(又)紅彤彤，又作紅通通},囱{(訓)},囪{(訓)煙囪，訓讀通}
tung2	tʰʊŋ35	㛚,𧚔{～裙，本字桶},統,桶,捅{捅破，捅穿}
tung3	tʰʊŋ33	痛
tung4	tʰʊŋ21	仝{姓},𦒍,鼕{(又)},鮦{鮦魚},銅,酮,詷{共同},衕{衚衕},茼{茼蒿},艟{艨艟},筒,童,穜{先種後熟的農作物},砼,瞳,犝,烔,潼,洞{澒洞；洪洞縣},橦{木棉樹},桐,曈,彤{彤雲，紅彤彤},峒{崆峒},峂,垌{地名，坰冢（在湖北）},哃,同{共同，同時；～點，怎麼},僮{書僮},侗{倥侗},佟
tyun1	tʰyn55	湍,猯,煓
tyun2	tʰyn35	疃
tyun3	tʰyn33	彖
tyun4	tʰyn21	團{團結},糰{糯米糰},槫,摶
tyun5	tʰyn24	斷{折斷，斷絕，保留濁上}
tyut1	tʰyt5	禿{(又)光禿禿，本字脫}
tyut3	tʰyt3	挩{解脫；遺漏},脱,脫{脫離},棁{棁杖},梲{杖},捝{解脫；遺漏}
u1	∅u55	嗚{(白)嗚呼[hu55]，表無奈或嘲諷，俗字噢/哦呵},𤏶{煨熟，後作爊},鏖,爊{同𤏶字，煨熟},熝{同𤏶字，煨熟}
u2	∅u35	哦{(語)表驚奇},媼{老媼，媼嫗},媪{同媼字},噢{(語)表驚奇}
u3	∅u33	哦{(語)～呵，表無奈或嘲諷，本字嗚呼},鿫,隩{通奧字},襖{棉襖},燠{甚熱},澳,擙,扷,懊{懊惱；懊悔},嶴,奧,墺,圫,噢{嘆詞；～呵，表無奈或嘲諷，本字嗚呼},嗚{(白)又音}
ui1	∅ui55	哎{(語)表招呼或感嘆，或作喂}
ui2	∅ui35	哎{(語)～唷[ju35]/喲[jɔ35]，表驚訝}
uk1	∅ʊk5	剭,齷{(常)齷齪},屋{房屋，屋子；～起、～底、～企[kʰi35]，家}
ung1	∅ʊŋ55	㙲{(白)},鶲{(又)},鎓{(又)},翁{(又)},壅{(白)埋，～肥},嗡{(又)}
ung2	∅ʊŋ35	擁{(白)推}
ung3	∅ʊŋ33	䐥,齆,蕹{蕹菜},罋{同甕字},甕{酒甕，入甕；～缸，水缸；量詞},瓮{罌也}
waa1	wa55	凹{同窪字},譁{譁然},蛙,花{(白)市區已罕讀},糀{(又)},窪,窊,畖,洼{同窪字},娃{娃娃},嘩{象聲詞，水流聲；同譁字},哇{哇哇大叫},咼{嘴歪斜},划{(又)划船}
waa2	wa35	娃{(白)娃[wa21]～崽，嬰兒；阿～，暱稱小孩},畫{(白)名詞，圖畫},搲{(文)}
waa3	wa33	化{(白)市區已罕讀},𠹁{小兒啼}
waa4	wa21	划{划船，划算，划拳（口語用猜碼）},驊,鏵,華{中華},樺{樺樹},崋,嘩{嘆詞},哇{(語)表讚歎，又作嘩字}
waa5	wa24	踝
waa6	wa22	哇{(語)表推測，今日冇落雨～？},話,觟{有角母羊},華{華山、姓，俗讀中華之華},舙,畫{(文)畫眉鳥，易受後字調類化爲陽平},崋{(又)},嬅
waai1	wai55	歪{歪曲，歪斜},溾{溾浽}
waai3	wai33	塊{(白)市區已罕讀},筷{(白)市區已罕讀},快{(白)市區已罕讀}
waai4	wai21	怀,淮,槐,懷
waai6	wai22	坏{同壞字},壞
waak6	wak2	㗲,𦑌{飛聲},𡄴,騞{騞然},籰{(白)收絲器},篗{(白)同籰字},穫{(白)收穫},砉,畫{動詞，畫圖},獲{(白)獲得},掝{裂開},或,惑,嫿,嚄{(白)嚄唶},劐{(又)},劃{計劃，劃分},剨,㩇{擘也}
waan1	wan55	壪,灣,彎
waan2	wan35	挽{(白)挽手，挽住},翫{(白)},綰,玩{(白)古玩，遊玩，玩弄，玩物喪志}
waan4	wan21	䴉,鬟,頑{頑童},闤,鐶,鍰,郇{姓},還{〈副〉還有，還是；〈動〉還錢，還原},繯,環{環境},澴,桓{(又)},寰,嬛{琅嬛},圜{環繞、圍繞}
waan5	wan24	挽{挽留，挽手，挽住},鯇{(文)},輓{輓聯}
waan6	wan22	宦,豢,翫{(文)},繯{(又)},玩{(文)古玩，遊玩},漶,擐{(又)},患,幻
waang1	waŋ55	硡{(語)搞～，搞砸了，又或本字搞崩，原讀前字韻尾的順同化}
waang4	waŋ21	橫{橫豎；蠻橫，古讀去聲}
waat3	wat3	嗗{飲聲},穵{(文)},斡{斡旋；地名，陸斡},挖{(文)}
waat6	wat2	滑{(文)滑冰；〈習〉滑稽},猾{(文)}
wai1	wɐi55	倭{倭遲},麾{(白)},隳{(白)},逶,輝{(白)光輝},覣,褘{(白)},蝛,葳,翬{(白)},癐{象聲詞},琿{(白)璦琿},爲{(白)難爲},煇{(白)},為{(白)},暉{(白)},撝{(白)},揮{(白)揮手},崴{崴嵬；崴子},媙,媁{好看、漂亮，～水，俗字威},威,委{虛與委蛇},噅{(白)}
wai2	wɐi35	位{(白)單位，坐位，一位，各位},骫,韡,韙,譭{詆譭},諉,虺{虺蛇},虫{虺的本字},薳{草名；姓},蔿,蒍,萎{枯萎，萎縮，氣萎},芔,緯,碨{碨磊},痿,瑋,燬{焚燬},煒,毀{毀滅},暐,廆{人名用字},委{委託},喂{(語)句首表引起注意，句末表祈使},唯{唯唯諾諾},卉,儰,偉{偉大，雄偉}
wai3	wɐi33	㜇,餵{餵養，餵飯},餧{餧飯，後作餵},霨,螱,蝟{(常)刺蝟，前字調類化},蔚{蔚然},翽,穢,磑{磨子},碨{石磨},畏,猥{猥瑣，讀同畏},慰,慧{(常)智慧，前字調類化},尉{太尉},噦{噦噦},喂{喚叫聲；同餧/餵字},偎{(常)依偎，讀同畏},䲁
wai4	wɐi21	唯{唯獨，唯物論},韋,闈,遺{遺失},違,葦{蘆葦},維{維護},琟,爲{作爲；〈語〉計算，～過，算起來，～得過，划得來，～冇過，划不來},為{同爲字},濰,潿,湋,惟{惟恐},幃,帷,圩{圩堤},圍
wai6	wɐi22	位{位置，地位，座位},𠅤,鏏,遺{贈也},譓,謂,諱,衞{同衛字},衛,蟪,蝟{刺蝟},蕙,胃,爲{爲了},煟,為{同爲字},潓,渭,橞,憓,慧{智慧},惠,恚,彙{(書)},彗,嘳{(又)},喟{喟嘆，讀同胃/謂}
wak6	wɐk2	掝{(語)～手，招手，疑本字劃/攉}
wan1	wɐn55	勛{(白)},鰮,鰛,馧{香},頵,閽{(白)},醺{(白)},轀,輼,贇,薰{(白)薰衣草},薀{水草名},蒕,蒀,葷{(白)},纁{(白)},縕{絪縕},緼{絪緼},瘟,獯{(白)},燻{(白)煙燻},熏{(白)熏陶},熅{無焰的火},煴{無焰的火},溫,温,氳{氤氳，氛氳},氲,殟,榲{(又)},榅{(又)},曛{(白)},暈{暈車},昏{(白)昏倒，黃昏},惛{糊塗},婚{(白)結婚，婚姻},勳{(白)}
wan2	wɐn35	揾{同搵字},穩,混{(白)相混，混合},搵{沒也；〈語〉找，一說本字溫/薀}
wan3	wɐn33	困{(白)囚禁，與屈對轉},韞,醞,醖,訓{(白)市區已罕讀},蘊,藴,薀{通蘊字，積聚},縕{亂麻；舊絮},緼{亂麻；舊絮},搵{按},揾{同搵字},慍,愠
wan4	wɐn21	云{詩云，人云亦云},魂,餫{餛飩},餛{餛飩},雲{彩雲，雲集},鋆{金},鄖,蕓{蕓薹},芸{芸香，芸芸},耘,紜,篔,筠{筠竹},琿{玉名；琿春市},澐,溳,渾{渾濁},沄,暈{頭暈},昀,妘,員{增益；古人名，伍員},匂{(又)},勻{均勻}
wan5	wɐn24	允{允許},隕,狁,殞,尹{姓}
wan6	wɐn22	員{姓},餫{運糧},韻,鄆,運,諢,熨{熨斗，本字熅},熅{熨},煴{熨},溷,混{(文)混帳，矇混},暈{日暈},惲,婫{覆蓋},圂
wang1	wɐŋ55	嗡{(語)～～響，嗡嗡響，又作耾字},耾{(語)～～響，嗡嗡響，又作嗡字}
wang2	wɐŋ35	奣
wang6	wɐŋ22	撔{橫也；〈語〉繞道、抄近路，或爲屈路行的合音，又或爲輷[kʷɐŋ22]（圈、繞）的音變}
wat1	wɐt5	㳚,黦{(又)黃黑色},魆{(白)},鬱{憂鬱},馧{馧馞},詘{辭塞；彎曲},蔚{地名，蔚縣（在河北）},菀{茂盛},膃,腽,胐{(白)},窟{(白)},爩{煙氣；燻，俗字煀，與燻對轉},熨{熨帖},煀{燻，本字爩，與燻對轉},榲,榅,屈{委屈；使彎曲；蜷縮，與困對轉},尉{尉遲，複姓},堀{(白)},倔{(又)},䓛
wat6	wɐt2	抇{同搰字，掘也；〈語〉攪動},鷸,鶻{鶻突，回鶻},遹,聿,矞,燏,潏{水流貌},核{果核，棗核},搰{掘也；擾亂}
wau1	wɐu55	汪{(語)象聲詞，狗吠聲，狗～～}
we2	wɛ35	噦{(語)嘔吐},搲{(白)撓，抓}
we6	wɛ22	唄{(白)語氣詞，又作𠹁字},𠹁{(語)句末語氣詞，相當於官話的唄}
wen4	wɛn21	環{(白)耳環},還{(白)〈動〉還錢，還原}
wen5	wɛn24	挽{(白)挽留，罕讀},鯇{(白)鯇魚}
wet1	wɛt5	滑{(語)～魚，黃鱔；魚～～，魚兒，童語}
wet3	wɛt3	挖{(白)},穵{(白)同挖字}
wet6	wɛt2	滑{(白)地滑，光滑},猾{(白)狡猾}
wik6	wek2	域{區域，領域},閾,蜮,棫
wing1	weŋ55	營{(語)象聲詞，～～嗡[wʊŋ55]嗡[wʊŋ55]，即嗡嗡營營，蚊蟲聲}
wing4	weŋ21	嶸{(又)},蠑{(又)},榮{(又)新讀}
wing5	weŋ24	咏{同詠字},詠{歌詠，詠歎},穎,潁,泳,永,栐
wo1	wɔ55	倭{倭寇},踒{踒腳},蝸,萵,窩,窠{(訓)訓讀窩},渦{漩渦},撾{老撾，讀同濄/渦},媧
wo2	wɔ35	倭{倭墮}
wo3	wɔ33	喎{語氣詞，表提醒或讚歎},𤆏,涴{弄髒}
wo4	wɔ21	和{和平，和氣；和麪},龢,禾,盉,啝{小兒啼}
wo5	wɔ24	喎{語氣詞，表祈使或反問},𢰸{～蛋，變質蛋，本字涴},涴{(語)～蛋，變質蛋，俗字𢰸}
wo6	wɔ22	和{附和，唱和},禍{禍害，災禍}
wok3	wɔk3	矱,雘,臒
wok6	wɔk2	劐{(又)},鸌,鑊{鍋},蠖,籰{(文)},篗{(文)},穫{(文)},瓠{瓠落},獲{(文)},濩{煮},彠,嚄{(文)}
wong1	wɔŋ55	尢{部首；同尪字},汪{汪洋，水汪汪；姓},尪
wong2	wɔŋ35	枉
wong4	wɔŋ21	凰,黃,鰉,餭,隍,鐄{大鐘},鍠,遑,蟥{螞蟥},蝗,艎,簧{彈簧},篁,磺,皇,癀,璜,瑝{玉聲},王{王朝},煌,潢,湟,惶,徨,媓,喤
wong5	wɔŋ24	往,暀{光；德；是}
wong6	wɔŋ22	旺{火旺},王{王天下},暀{同旺字}
wu1	wu55	嗚{嗚呼，嗚咽},𠌥{(又)},靰,鎢,鄔,肟{(又)讀同污},烏,洿,污{同汙字，污泥，貪污},汙{汙泥，貪汙},於{於戲，於菟},塢{山塢，船塢},圬
wu2	wu35	祜
wu3	wu33	噁{喑噁},𠌥,惡{可惡}
wu4	wu21	乎{幾乎，在乎；〈語〉貌[mau55/ma55]～，副詞，頗、蠻，原讀的語流音變，又弱讀爲貌啊[a22]，俗作貓胡/嗎胡},鶘,鬍{鬍鬚},餬{餬口},醐,衚{衚衕},蝴,葫{葫蘆},胡{胡琴},糊{糊塗},瓠{瓠蘆，同葫蘆},瑚,猢,狐,煳,湖,弧,壺,和{打麻將和牌，又作胡牌}
wu6	wu22	互{互相，相互},鱯,鄠,護,芋{芋頭，易受後字調類化爲陽平；～蒙，芋葉莖},瓠{瓠瓜，瓠子},濩{布散},滬,昈,扈,户,戶,怙,岵,嫭,冱
wui1	wui55	偎{依偎},鰃,隈,煨{煨番薯},溾{(語)溾浽（污穢、骯髒），又作渨涹},渨,椳
wui2	wui35	會{(白)委員會，大會堂，會員}
wui4	wui21	回,迴,蛔,茴{茴香},烠,洄,徊
wui5	wui24	會{冇～，不會，語流中易讀陰去}
wui6	wui22	匯{匯聚},薈{蘆薈，薈萃，讀同會},繪,繢,燴,會{開會；會計；會稽},彙{(習)詞彙，讀同匯}
wun1	wun55	婠
wun2	wun35	剜,豌{豌豆},腕,脘{(又)},碗,椀,惋{惋惜},宛{宛如},婉{婉轉}
wun4	wun21	垣,雈,貆,萑,荁,綄{候風羽},瓛,洹,桓{盤桓；姓},峘
wun5	wun24	㬊,莞{莞爾},緩,綄{纏繞},皖{安徽},浣
wun6	wun22	喚,逭,翫{(書)},瘓,玩{(書)},煥,渙,換,妧{美好貌},奐
wung1	wʊŋ55	嗡{(語)象聲詞，營[weŋ55]營[weŋ55]～～，即嗡嗡營營，蚊蟲聲}
wut6	wut2	佸,活
zaa1	tʃa55	偺{同咱字},𠭯,齇,髽,蹅{足蹋聲},膼,碴,猹,渣{殘渣，渣滓},樝{山樝，又作山柤},楂{山楂},查{同楂字；姓},柤{山柤，即山樝},撾{敲、打},摣{握、拿},揸{同摣/𠭯字，握、拿},挓,抯,抓{握、拿，又作揸字，本字摣/𠭯},奓{地名，奓河、奓山（在湖北）},喳{象聲詞，擬鳥聲，吱吱喳喳，吱喳蟲（知了）},喒,咱,吒{哪吒}
zaa2	tʃa35	䕢{藞䕢},鮺,鮓{鮓肉},苴{土苴；〈語〉劣質的},砟{砟子},渣{(語)發爛～，撒野}
zaa3	tʃa33	䃎{地名用字},詐,蜡{年終祭名},蚱,笮{榨酒器},砟{碑石},痄{痄腮},煠{油炸之炸本字},炸{炸彈，本字灹；油炸，本字煠},灹{火聲},溠,榨{榨油},搾,拃{測長度；量詞},奓{張開},咋{咋舌，咋呼，咋辦},乍
zaa4	tʃa21	喳{(語)豬屎～，喜鵲；衝/追/趯～～，急衝/追/跑貌；嘈～～，嘈雜貌}
zaa6	tʃa22	柞{地名，柞水（在陝西）},𧨊{𧧝～，囉嗦、糾纏},齰{齰齖},槎{逆斫木；枒～，佔地、霸道}
zaai1	tʃai55	齋
zaai3	tʃai33	債,祭{姓},瘵
zaai6	tʃai22	㨁{(白)投擲，韻母演變同踩/跐字},豸{(又)},砦,廌{(又)},寨,㩟{縫綴}
zaak3	tʃak3	㩇{裂聲},迮,賾,責,舴,簀,笮{狹窄；姓；〈語〉壓，俗字矺/磧},窄,矺{磓也；同磔字},柞{砍，斜斫},幘{(又)},嘖,唶{嚄唶}
zaak6	tʃak2	䶡{同齰字},齰{齰舌},躑{躑躅},蹢{蹢躅，同躑躅},謫,翟{姓},磔{張也開也},澤,泎{水落貌},擿{搔，撓；投擲，後作擲},擲{投擲，古字擿},擇{擇菜},摘,宅
zaam1	tʃam55	簪,糌
zaam2	tʃam35	䁪,鏨{(白)鏨花，鏨子},斬{(文)},嶄,寁
zaam3	tʃam33	偡,蘸{蘸墨},湛
zaam6	tʃam22	暫,鏨{(文)},蹔,站{站立；車站}
zaan2	tʃan35	㜺{好看、漂亮},驏,趲{趕路；移、挪；走～，走板、錯位},賺{(白)～得，徒然、落得},盞{(文)},琖,棧{(白)客棧，棧房},昝{姓},攢{(文)},拶{舊時酷刑},儹{(文)}
zaan3	tʃan33	濽{同灒字},酇{古縣名；姓},贊{贊助，贊成},讚{稱讚，讚揚},瓚,灒{水濺，又作濽字}
zaan6	tʃan22	䗃{馬䗃},賺{賺錢，賺取；～得，徒然、落得},虥,綻{破綻},棧{(文)棧道，馬棧}
zaang1	tʃaŋ55	㬹{肘、腳跟，俗字踭},踭{肘、腳跟，本字㬹},爭{爭取；欠、差},掙{(又)掙脫},丁{伐木丁丁}
zaang6	tʃaŋ22	䂻{硬塞；撐、飽肚}
zaap3	tʃap3	偛,𥀈{皮老},譗,紮{(語)～馬步，又作劄字},砸{砸傷，讀同匝},眨{眨眼},抸,扎{(語)～馬步，又作劄字},咂,匝,劄{用針劄，劄記；～馬步，又作紮/扎字}
zaap6	tʃap2	喋{唼喋},雜,閘{水閘，閘門，本字牐},鍘{(訓)鍘刀，訓讀閘},紮{(語)馬～，又作閘字},牐{閉城之門},扎{(語)馬～，又作閘字}
zaat3	tʃat3	哳,軋{碾軋；象聲詞；軋鋼},蚻{小蟬},紮{包紮，駐紮，一紮},札,拶{逼，擠壓},扎{扎針，掙扎}
zaat6	tʃat2	㳐{水流貌；水聲},甴{曱～，蟑螂，本字甲蚻，前字受後字逆同化}
zaau1	tʃau55	啁{啁哳；啁嘐},嘲{嘲諷，嘲笑}
zaau2	tʃau35	找{尋找},爪{(文)},抓{搔、撓}
zaau3	tʃau33	㷹{(文)油～鬼，油條},𦻐{(文)},罩{(文)口罩},笊{(文)},炸{(文)}
zaau6	tʃau22	棹{(文)},櫂{(文)}
zai1	tʃɐi55	劑{藥劑},齏,齎,隮,躋{躋身；〈語〉放置，又作擠字},擠{排擠，擠迫，擁擠；〈語〉放置，又作躋字}
zai2	tʃɐi35	仔{仔女，本字崽},濟{人才濟濟；濟南},滓{(訓)渣滓，訓讀崽/仔},崽{(白)小子或動物幼子，俗字仔},囝{兒子}
zai3	tʃɐi33	䎺{願意；合算},鰶,霽,際,迣,製{製造，製作},穄{穄子},祭{祭祖},磜,狾,濟{經濟},漈,晢{(又)},掣{掣肘，風馳電掣；〈語〉開關，本字制},制{制度，制止；〈語〉開關，俗字掣}
zai6	tʃɐi22	嚌{嚐；〈語〉罷～，罷了},齊{火齊},癠,滯{停滯},懘
zak1	tʃɐk5	仄,鰂{鰂魚，即鯽魚},鯽{(習)鯽魚},昃,則,側{側面，兩側}
zam1	tʃɐm55	斟,鍼{鍼砭，鍼灸},鍖{同椹字},針{針線，針對},葴,箴,祲,砧{擣衣石；同椹字，砧板},瑊,椹{墊板，砧板}
zam2	tʃɐm35	怎,枕{(名)枕頭}
zam3	tʃɐm33	揕{刺也；擊也},譖{譖言，毀譖},浸{浸泡，水浸（水淹）},枕{(動)墊枕，枕戈待旦}
zam6	tʃɐm22	朕,鴆,陣{(語)量詞，股，一～味/氣，受味字逆同化變讀韻尾，俗字朕},沉{(白)沒入水中，本字沈},沈{沒入水中，～水，溺水，俗字浸}
zan1	tʃɐn55	嶟,鷷,迍{迍邅},諄,衠,蓁{草盛貌},臻,胗{胗肝},肫{肫肫；雞肫},罇{同樽字},繜,窀,禛,真,眞,甄{甄別；姓},瑧,珒,珍,溱{溱頭河},津,樽{盛酒器；〈語〉瓶},樼,榛,忳{同諄字}
zan2	tʃɐn35	儹{(白)聚也},隼{鷹隼，讀同準},陣{(又)舊～時，過去},縝{(又)},綧,稹{(又)},準{標準，準備},槙{(又)},槇{(又)},攢{(白)積攢},埻{箭靶},准{批准，准予}
zan3	tʃɐn33	俊,駿,餕,顫{(訓)訓讀震},震,雋{同俊字},鎮,鎭,進,賑,葰{大},臸{前往},縉,竣,睃{(又)},畯,甽{溝渠},璡,瑱{通鎮字；瑱圭},瑨,焌{點火},濬{深也；疏通},溍,浚{深也；疏通},晙,晉,振,峻{峻嶺},圳{深圳；溝渠，本字甽},儁
zan6	tʃɐn22	儘{儘管，儘量},陣{佈陣，陣雨；阿/嚕/舊～時，這/那/舊時候},贐,藎,紖,盡{耗盡},燼,濜,敶
zang1	tʃɐŋ55	䎖,鬙{鬅鬙},鬇,錚,罾{魚網，魚～},繒{絲織品總稱},綪{屈曲},箏{風箏},矰,睜,琤,猙,曾{姓},掙{掙脫，掙扎},憎,崢,增,噌{象聲詞},僧{僧人，唐僧，讀同曾},䒏{䒐䒏，神不爽也}
zang2	tʃɐŋ35	盯{(白)䁅[mɐŋ35]～，暴躁、使性子},𤺧
zang3	tʃɐŋ33	甑{飯甑，甑子},諍{諍言}
zang4	tʃɐŋ21	噌{(語)詞綴，趯[tɛk3]～～，四處逃竄}
zang6	tʃɐŋ22	掙{掙錢},贈,繒{綁；紮}
zap1	tʃɐp5	執{執行，執筆；檢查，～漏，檢漏},臢{腌臢（不潔）},縶,汁
zap6	tʃɐp2	㗱,鰼,霫{霫霫},集,隰,襲,習,嶍,㿇{痺疾}
zat1	tʃɐt5	㰵{(又)},騭,鑕,質{質量；人質，古讀去聲，陟利切},蟀{(語)織～，蟋蟀，又作蜶字},蜶{(又)},窒{(白)動詞，塞；瓶塞；屈～，狹小},礩{柱下石},櫍,晊,揤{捽；拭},崒{(又)},卒{兵卒}
zat6	tʃɐt2	侄{同姪字},銍,郅{郁郅},螏,蛭,蒺,膣,窒{窒息，窒礙},礩{通窒字},疾{疾病；〈語〉長不大的，～崽},甴{(又)},桎,朮{白朮},挃{撞；割禾聲},庢{盩庢縣},嫉,姪{姪子，堂姪},厔{同庢字}
zau1	tʃɐu55	周{周圍，四周，周全；姓；～時，經常、時常},𩭓{梳個𩭓，又作鬏字},鵃,鯫,鬏{梳個鬏},騶,陬,鄹,鄒,週{週期，週刊，週末},輈,賙,譸,謅{瞎謅，胡謅},諏,蝤{蝤蛑},舟,盩{盩庢縣},湫{湫水河},洲,揫{揫住},揪{同揫字，揪住},掫{巡夜打更},州,婤,喌{呼雞聲},啾{啾唧},啁{啁啾}
zau2	tʃɐu35	帚,酒,走{走路；奔走},肘
zau3	tʃɐu33	㑳,蔟{(又)太蔟},縐{文縐縐，縐紗},皺{皺紋，褶皺},椆{木椆},晝,揍,奏,咒,㥮
zau6	tʃɐu22	㠇,鷲,鮦{鮦陽},驟,酎,袖,葤{裹也；量詞},胄{貴胄，世胄},繇{卦兆辭},紂{桀紂},籀,岫,就,宙,冑{甲冑，介冑},僦,㩆
ze1	tʃɛ55	啫{啫啫煲，啫喱},遮,姐{(白)家姐，阿姐；姐[tʃɛ55/tʃɛ21]姐（年齡較大前字讀陰平，年齡較小前字讀陽平）},嗻,嗟
ze2	tʃɛ35	姐{姐姐，姐弟},鍺,赭,者,毑
ze3	tʃɛ33	䗪,鷓{鷓鴣},藉{藉口，慰藉，憑藉},蔗{甘蔗，蔗糖},柘,唶{歎聲},借{借用，借貸，假借}
ze4	tʃɛ21	喳{(語)笑～～，笑嘻嘻，吆～～，叫喳喳}
ze5	tʃɛ24	這{這邊；又～又那，形容麻煩事多}
ze6	tʃɛ22	榭,謝{多謝；姓}
zek3	tʃɛk3	嵴,鶺,隻{一隻},蹠,蹐,跖,脊,瘠,摭
zek6	tʃɛk2	席{草席，又作蓆字},褯{褯子},蓆{草蓆}
zem2	tʃɛm35	斬{(白)}
zem3	tʃɛm33	蘸{(白)}
zen2	tʃɛn35	盞{(白)燈盞，一盞燈}
zeng1	tʃɛŋ55	精{(白)～靈，機靈，精的分音}
zeng2	tʃɛŋ35	丼{(白)同井字},阱{(白)陷阱},肼,汫,井{(白)水井，井井有條}
zeng3	tʃɛŋ33	正{(白)正斗，正嘢}
zeng6	tʃɛŋ22	凈{(白)},淨{(白)乾淨}
zep1	tʃɛp5	㗱{(語)吸奶聲}
zep6	tʃɛp2	㗱{(語)咀嚼聲}
zet1	tʃɛt5	擳{(白)擠；胳肢（動詞）},瀄{(白)擠水濺出，與濺對轉；泌～，同義複用，引申爲排斥、開除}
zet6	tʃɛt2	截{(白)白～～，慘白}
zeu1	tʃɛu55	啁{(白)吱吱～～，唧唧喳喳},焦{(白)飯焦，鍋巴}
zeu2	tʃɛu35	找{(白)找錢},爪{(白)爪牙}
zeu3	tʃɛu33	㷹{(白)用油炸；油～鬼，油條},𦻐{(白)同㷹字},罩{(白)罩住},笊{(白)笊籬},炸{(白)用油炸，本字㷹}
zeu6	tʃɛu22	棹{(白)同櫂字，棹船，棹歌},櫂{(白)槳；划}
zi1	tʃi55	㞢{同之字},𦭜,齜,齍,齊{齊衰},鼒,鶅,鳷,鯔,髭,鎡,錙,鈭,鄑,輜{輜重},趑,資,貲,諮,訾{衡量；姓},觜{二十八宿之一},衼,螆,蜘{蜘蛛},菑{田一歲},茲{茲日},芝,臸{到達；如一},脂,胝,胑,肢,緇,粢,秪,祗,知{知道；知識},畠{同甾字},甾{同淄字},澬{久雨積水；水名},滋,淄,泜{泜河},汥{水聚積},氏{月氏，閼氏},榰,椥,椔,梔{梔子花},栺{栺栭},枝{樹枝，荔枝，一枝花},支,擠{(語)動詞或形容詞，表擁擠，官話借詞},恣{恣意，恣睢，讀同資},巵{巵言，玉巵},嵫,孳,孜,孖{雙生子},子{(白)等下子，一下子，一陣子},姿,嗞,咨,呲{同齜字},吱,卮{同巵字},之,䊷
zi2	tʃi35	㧗,黹,阯,酯,軹,趾,訿,訾{詆毁},衹{通祇字},虸,茝{白芷},茋,茈{茈草},芷,芓{同耔字},胏,耔,紫,紙,籽,笫,秭,祉,祇{同只字，僅僅；〈又〉神祇},疻,滓{渣滓，泥滓},沚,汦,止,梓,栺{木名},枳,杍,旨,指,扺,恉,徵{五音之一},子{子孫，瓜子},姊{姊妹，姊弟},坁,址,咫,呰,只{只有},厎,凪,仔{仔細；仔肩}
zi3	tʃi33	伿{(又)},鷙,騺,駤,輊,躓,贄,識{標識，博聞強識},誌{雜誌},觶,致{導致},至,胾{切成大塊的肉},置,緻{細緻，精緻，讀同致},稚{(常)幼稚，前字調類化},礩{(又)柱下石},知{通智字；姓},痣,疐{跋前疐後},潪{水名},梽,智,摯,懫,懥,忮,志{志向},寘,剚,倳
zi6	tʃi22	㨁{投；持},雉{雉雞},阤{山坡},跱,豸{蟲豸，獬豸},芓{同茡字；隄},自{自己，各自},耜,稚{幼稚，稚嫩},痔,畤,牸{牸牛},滍,泜{水名，在河南},治,歭{同偫字},杝{析薪},徥{(又)},彘,廌,庤,峙{對峙},寺{(又)},字{漢字；一個～，五分鐘},兕,傂,偫
zik1	tʃek5	勣,鯽{(書)},陟,蹟{古蹟，遺蹟},踖,跡{足跡，跡象},襀,蠀{尺蠖蟲},蟋{(訓)～蟀[tʃɐt5]，訓讀織蟀},膱{油敗；脯脡},職,織,績,積,稷,磧{沙磧},癪,炙{炙熱},漬{(訓)污漬，浸漬，訓讀積},樴,擿{(又)},擲{(又)},幟{(常)旗幟，讀同織},幘,尐{有花紋的雌蟬},堲,唧{啾唧，唧咕，唧唧},卽{同即字},即{即刻，立即}
zik3	tʃek3	瘠{(又)},鶺{(又)},隻{(又)},蹠{(又)},蹐{(又)},脊{(又)}
zik6	tʃek2	㨁{拄杖},褯{(又)},蟄{驚蟄},藉{狼藉},耤,籍,穸,稙{早種禾},矽,直,潪{水稍滲入土},湜,汐,殖,植,席{主席},寂{寂寞},夕,埴,值
zim1	tʃim55	䀡{同覘字},霑,譫,詹,覘{窺視},襜{(又)},粘{粘米（秈米），又作占米},瞻{瞻仰},漸{漸染},沾,櫼{(又)},憸{(語)㤿～，愛挑剔},嶦,尖,占{占卜，占卦}
zim2	tʃim35	颭
zim3	tʃim33	佔{佔領，侵佔}
zim6	tʃim22	漸{逐漸}
zin1	tʃin55	戔,鸇,鳽{同鸇字},鱣{鱘鰉魚},饘,韉,煎{煎熬，油煎},濺{濺濺，水疾流貌},湔{湔洗，湔滌},氊,氈{毛氈，氈帽},栴,旃
zin2	tʃin35	剪,𦟌,輾{輾轉},蹍,踐{實踐},趼{(又)},譾,諓,翦,搌,戩,展,媊,囅{(又)}
zin3	tʃin33	戰,餞{餞行，蜜餞},顫{顫抖，打顫},薦,荐,箭,牮
zin6	tʃin22	濺{濺水，與瀄對轉},賤,纏{(又)}
zing1	tʃeŋ55	偵{偵察},鼱,鶄,鯖{魚肉雜燴},鉦{古樂器},貞,蒸,菁,腈{精肉；有機化合物的一類},精{精神，妖精},箐{笭箐},禎,睛{眼睛},癥{癥結},烝,湞,正{正月},楨,晶,旌,怔,徵{徵求},征{征伐}
zing2	tʃeŋ35	丼{(文)},整,撜{同拯字},拯{拯救},井{(文)}
zing3	tʃeŋ33	幀,證,証,症{症狀},正{正確，方正；～式、～經，確實},政
zing6	tʃeŋ22	䝼{賜予},靜,靚{裝飾也},靖,阱{(文)},鄭,竫,瀞,淨{淨重；～係，光是},婧,剩{(習)剩餘，剩下},凈{同淨字}
zip3	tʃip3	䀹{(又)},霅{霅溪},輒,讋,褶{皺褶，百褶裙},浹{浹洽，汗流浹背},楫{(又)舟楫},摺{摺疊，存摺},接,囁{(又)}
zit3	tʃit3	㘉{咇㘉},轍,踅{(訓)折回，訓讀折},蜇{蠍子蜇人，海蜇},節,癤,瀄{瀄汨，泌瀄},浙,櫛{櫛比，讀同節},晢,擳{挃擳},折{折斷，打折；弄折了},悊,岊,尐{少},嚞,喆,哲,㵶
zit6	tʃit2	婕,睫{睫毛},捷{快捷，敏捷},截{截斷；量詞}
ziu1	tʃiu55	僬{僬僥},鷦,鉊,詔{(常)詔書，詔告，讀同招},蕉{芭蕉},礁,燋{引火用的柴},焦{焦土},沼{(常)沼澤，沼氣，讀同招},椒,朝{朝早，今朝},昭{(又)},招,召{(訓)召喚、召集，訓讀招}
ziu2	tʃiu35	剿{剿滅},湫{低窪},沼{沼澤，沼氣},摷{拘擊},勦{勞也}
ziu3	tʃiu33	僬{僬僬},醮{打醮},詔{詔書，詔告},皭,照,炤{同照字},曌,嘦{吳語字，只要}
ziu6	tʃiu22	兆,鮡,銚{放射性化學元素},趙,旐,噍{嚼},召{號召}
zo2	tʃɔ35	佐{輔佐，佐料},阻,詛{詛咒},左,岨{同阻字，險要},唨{粵字，咗的舊寫，見咗字},咗{粵字，表完成，一說源於着字；本地用嗮，極其老派用[tʃœ35/tʃɛ35]➔[hœ35/hɛ35]，相當於作結果補語的嗮，或與咗同源},俎
zo4	tʃɔ21	趖{(語)詞綴，走～～，疾行貌；滾～～，熱鬧貌；崩～～，倒塌貌}
zo6	tʃɔ22	助,昨{(語)語流音變},座,唑{咔唑，噻唑}
zoe1	tʃœ55	啫{(又)啫啫煲；～～聲，油炸聲}
zoe4	tʃœ21	啫{(又)～～聲，鞭炮引線點着聲}
zoek3	tʃœk3	䓬,鐯,酌,著{衣著，著衫，俗作着},芍{芍藥},繳{繫在箭上的絲繩},禚,着{衣着，着衫},皭{(又)},爵,爝,灼,汋{激水聲},桌{桌面，書桌，舊讀},晫,斮{斬也},斫{斧刃；斧砍},妁,嚼,卓{卓越，卓著，舊讀},勺{通酌字},倬
zoek6	tʃœk2	着{着涼，睡着；棋高一着（口語用招）},著{著涼，睡著；棋高一著（口語用招）；俗作着}
zoeng1	tʃœŋ55	嫜,鱂,鄣,蟑,章,璋,獐,漿{豆漿，漿糊},漳,樟,暲,彰,張,將{將來}
zoeng2	tʃœŋ35	丈{(白)姨丈，姑丈},鞝{扇馬鞍皮},長{生長},蔣,獎,漲{(又)漲水，漲價},槳,掌,奬,仉{姓}
zoeng3	tʃœŋ33	仗{打仗，勝仗，敗仗},障{保障},醬,賬{賬目},脹,瘴{瘴氣},漲{漲水，漲價；漲大},幛,帳{蚊帳},嶂,將{大將}
zoeng6	tʃœŋ22	丈{丈夫，丈量},長{(又)身無長物},象,蟓,橡{橡樹},杖,匠,像,仗{倚仗，炮仗，儀仗}
zoet1	tʃœt5	㰵{(白)吮吸；吻；又作嘬字},嘬{(白)吮吸；吻；本字㰵}
zoi1	tʃɔi55	哉,菑{同災字},甾{有機化合物的一類},灾,災,栽
zoi2	tʃɔi35	宰,載{年載，俗讀載重之載},崽{子也}
zoi3	tʃɔi33	再,載{載重，滿載，記載}
zoi6	tʃɔi22	在
zok3	tʃɔk3	㧻{刺木},諑,琢{琢磨，雕琢},涿{地名，涿州、涿鹿（在河北）},椓,桌{(又)},晫{(又)},捉{捉拿，捕捉},卓{(又)},倬{(又)},作{工作，作坊},䓬{(又)},䐁{臀；肥}
zok6	tʃɔk2	岞,鷟,鑿{開鑿；鑿子},酢{酬酢},笮{竹索},砟{砟硌},濯,浞{水溼},柞{柞木，柞蠶},昨{昨晚，昨日},擢,怍
zong1	tʃɔŋ55	妝{化妝，妝扮},髒{骯髒},贓{贓物，貪贓},裝,莊,臧,粧{同妝字},牂,樁,庄
zong2	tʃɔŋ35	駔{壯馬；駔儈}
zong3	tʃɔŋ33	壯{強壯},葬,戇{戇直},壵
zong6	tʃɔŋ22	僮{僮族},藏{寶藏},臟{內臟},狀,漴,撞,幢{量詞},奘{粗大；玄奘}
zu1	tʃu55	租,遭,糟
zu2	tʃu35	早,駔{駿馬},蚤,藻{水藻，小球藻},繰{絳紫色帛},組,祖,璪,璅{似玉的石},珇,澡,棗
zu3	tʃu33	做{做工，做人},竈{爐竈，竈神},灶{同竈字}
zu6	tʃu22	唕,阼,造{製造；造詣，古讀七到切},胙,簉,祚,皂{肥皂},皁{皁角},慥{(又)},唣
zui1	tʃui55	䘒{赤子陰},騅,隹,錐{圓錐},追,脧{赤子陰},椎{椎骨，頸椎},朘{赤子陰}
zui2	tʃui35	嘴{嘴巴},觜{鳥嘴},沝
zui3	tʃui33	㙍{地名用字},醉,蕞,綴{點綴，綴合},檇{檇李},槜,最,晬,惴
zui6	tʃui22	䃍{(又)},𢶀{拉，俗字拽},贅{累贅，贅言},膇,罪,縋,綴{(又)},拽{用力拉，本字𢶀；扔},懟{(又)},墜
zuk1	tʃʊk5	喌{(又)},鐲{(白)},足,蠋,蜀{(常)蜀國，蜀道，讀同燭},粥,竺,竹,祝,矚,瘃,燭,柷{柷敔},屬{屬文，屬望},囑{囑咐，遺囑}
zuk6	tʃʊk2	俗{風俗},鐲{手鐲},鏃,逐,軸,躅{躑躅},藚,舳,續,濁,族,妯,嗾{(又)}
zung1	tʃʊŋ55	䁓,鬷,鬃,騣,鐘{鬧鐘},鍾{鍾情，鍾意},迚,蹱{躘蹱},蹤,衷,螽,舯,腙,綜{綜合；織縷，古讀去聲},終,盅,潨{崖岸},潀{崖岸},淙{(習)淙淙},樅{地名，樅陽（在安徽）},椶,棕,柊{(又)},忪{怔忪},忠,宗,倧,中{中間，當中}
zung2	tʃʊŋ35	傯,踵,腫,總,種{種類},种{同種字},熜{用麻莖捆扎成的火炬},摠,塚{同冢字},冢{枯冢}
zung3	tʃʊŋ33	䝋{公豬},衆{同眾字，衆多，大衆},糉{糉子},粽{同糉字},種{種植},种{同種字},眾{眾多，大眾},瘲,偅,中{中計，打中；〈語〉正好處在、恰好處於，～一間房、～一隻部門}
zung6	tʃʊŋ22	仲{伯仲；副詞，還、仍，本字重},頌,重{副詞，還、仍，俗字仲},誦,訟,茽,縱{放縱；縱橫，古讀平聲}
zy1	tsɿ55	䊷{(老派)},齜{(老派)},齍{(老派)},齊{(老派)齊衰},鼒{(老派)},鶅{(老派)},鯔{(老派)},髭{(老派)},鎡{(老派)},錙{(老派)},鈭{(老派)},鄑{(老派)},輜{(老派)},趑{(老派)},資{(老派)},貲{(老派)},諮{(老派)},訾{(老派)},觜{(老派)},螆{(老派)},菑{(老派)},茲{(老派)},緇{(老派)},粢{(老派)},畠{(老派)},甾{(老派)},澬{(老派)},滋{(老派)},淄{(老派)},椔{(老派)},恣{(老派)},嵫{(老派)},孳{(老派)},孜{(老派)},孖{(老派)},子{(老派)白讀，等下子，一下子，一陣子},姿{(老派)},嗞{(老派)},咨{(老派)},呲{(老派)}
zy2	tsɿ35	㧗{(老派)},訿{(老派)},訾{(老派)},虸{(老派)},茈{(老派)},芓{(老派)},胏{(老派)},耔{(老派)},紫{(老派)},籽{(老派)},笫{(老派)},秭{(老派)},滓{(老派)},梓{(老派)},杍{(老派)},子{(老派)},姊{(老派)},呰{(老派)},仔{(老派)仔細；仔肩}
zy3	tsɿ33	倳{(老派)},胾{(老派)},剚{(老派)}
zy6	tsɿ22	兕{(老派)},芓{(老派)},自{(老派)},耜{(老派)},牸{(老派)},寺{(老派)},字{(老派)}
zyu1	tʃy55	侏,雎,銖,邾,趄{趑趄},豬,諸,誅,蛛,藷{藷蔗},葅,菹,茱,苴{苴麻},硃{硃砂},砠{同岨字},疽,珠,猪{同豬字},狙,瀦,洙,沮{沮水},櫫,櫧,株,朱{姓},岨{石山戴土},娵,姝
zyu2	tʃy35	主,齟,麈,鉏{鉏鋙},煮,煑{同煮字},渚,沮{沮喪},拄{拄柺杖},岨{岨峿},咀{咀嚼}
zyu3	tʃy33	沮{沮洳},駐,鑄,註{註解},蛀,著{著作},翥,疰,炷,注{注意}
zyu6	tʃy22	住,駐{(又)},跙{行不進也},芧{橡樹或橡實},聚,箸{下箸，箸籠；量詞},漵,敘{記敘，敘事},敍{同敘字},序,嶼{島嶼},垿
zyun1	tʃyn55	專,鷷{(老派)},鱒,顓,鑽{(動)鑽研},鐫,鐏,遵,迍{(老派)},躦,諄{(老派)},衠{(老派)},膞{雞膞},脧{減縮；剝削},肫{(老派)},耑{同專字},罇{(老派)},繜{(老派)},窀{(老派)},磚,珒{(老派)},津{(老派)},樽{(老派)},朘{減縮；剝削},忳{(老派)},嶟{(老派)},尊
zyun2	tʃyn35	僔,隼{(老派)},轉{轉送，旋轉},綧{(老派)},準{(老派)},撙,孨,埻{(老派)},囀,噂,准{(老派)}
zyun3	tʃyn33	轉{轉動，轉螺絲},鑽{(名)鑽子}
zyun6	tʃyn22	䉵,饌,譔,纘,纂{編纂},籑,篆,瑑,沌{水名},旋{(白)髮旋},攥{攥緊，攥拳},撰,僝{具備},僎{具備},傳{傳記}
zyut1	tʃyt5	㰵{吮吸；飲},蟀{(語)～～，蟋蟀，又作蜶字},蜶{(又)},崒{(又)},卒{(老派)}
zyut3	tʃyt3	剟,輟,裰,蕝,茁,腏{骨間髓},絀,歠,欼,棁{梁上的短柱},梲{梁上的短柱},敠{(又)},撮{(又)},掇{拾掇；掂掇},拙{拙作，笨拙，勤能補拙},惙,嘬{吮吸},啜{喝；啜泣},叕
zyut6	tʃyt2	崒,絕,椊,枠,捽{揪},拙{(又)笨拙，前字調類化；勤能補拙}
