爲了兼容不同平臺的顯示，此處列出轉換字表，需要時可批量替換
------------
⿰口罈	𰉊
⿰平刂	𫥶
⿰弄動	𰅙
⿰弄迷	𰻖
⿰忄夹	𫺂
⿰米乙	𬖋
⿰老吉	𮋜
⿰谷列	𰶓
⿰車奔	𮝔
⿰足乙	𮛁
⿱打末	𰓮
⿱松土	𰉹
⿵门可	𬮠
⿸疒妾	𰣴
⿸疒王	𭼆
⿺包谷	𰶒
⿺辶彭	𮟊
⿰身必	𰸽