JYUTPING	IPA	CHAR
aa1	∅a53	丫{丫頭},鴉{烏鴉，鴉片},痾,屙{屙屎，屙尿},啊{表驚訝},吖{吖嗪，吖啶黃；嘆詞}
aa2	∅a33	啞{啞巴，聾啞},嗄{同啊字}
aa3	∅a55	亞{亞洲；近指代詞，這，又作阿字，本字箇},阿{阿哥；近指代詞，這，又作亞字，本字箇},錒,氬,掗{掗賈},婭,埡,啊{表應諾；句末助詞},呀{助詞}
aa4	∅a21	啊{表惋惜；吆～～，哇哇叫}
aa5	∅a24	啊{表疑問}
aa6	∅a22	十{(語)弱讀，數詞的連讀音變},啊{句首表應答、醒悟或讚歎，句末爲助詞}
aai1	∅ai53	㗒,鎄,欸{歎也},挨{挨近，挨住},娭{娭毑},埃{塵埃；埃及，蘇維埃},噯{同哎字},唉{應答聲；唉聲嘆氣},哎{哎喲，哎呀},哀
aai2	∅ai33	噯{噯氣；嘆詞},靉,靄{霧靄},藹{和藹},毐,欸{欸乃},堨{塵埃}
aai3	∅ai55	僾,餲{(又)},隘{隘口，險隘},璦,曖{曖昧},愛,嬡,嗌{噎也}
aai6	∅ai22	唉{表惋惜}
aak2	∅ak3	亦{(白)～隘[e55]，胳肢窩，後作腋},腋{(白)～隘[e55]，胳肢窩，古字亦},惡{善惡，惡人},堊,噁{二噁英},噁{噁心}
aam1	∅am53	媕,鵪{鵪鶉},諳,菴{菴藹},腤,盦,庵{尼姑庵},广{同庵字}
aam2	∅am33	咹{同唵字},黯,罯{魚網},揞{用手捂，與搕對轉},埯{小坑；量詞},垵{同埯字；地名，新垵（在福建）},唵{含}
aam3	∅am55	唵{唵嘛呢叭咪吽},闇{愚闇},暗
aan1	∅an53	安,鮟,鞍,鞌,氨,桉{桉樹}
aan2	∅an33	銨
aan3	∅an55	咹{聲止},鷃,胺{有機化合物},桉{同案字；〈又〉桉樹},案,晏{晚也，睡得～，睡得晚，～中，中午},摁{用手按壓},按
aan5	∅an24	俺{俗字，我，摹官話音，一說源自官話我們的合音}
aang1	∅aŋ53	罃{長頸瓶},骯{骯髒},肮{同骯字},罌{罌粟；瓦罐}
aang3	∅aŋ55	盎
aap2	∅ap3	㳌,鴨,押{抵押，押送},壓{(又)本讀}
aat2	∅at3	咹{吃},餲{食物腐臭變味},頞,閼{閼塞},遏,胺{肉敗},猰,揠,壓{壓扁，氣壓},堨{阻塞；堤堰}
aau1	∅au53	凹{凹陷，下凹},𤏶{煨熟，後作爊},鏖,爊{同𤏶字，煨熟},熝{同𤏶字，煨熟},嗷{(語)嚎聲}
aau2	∅au33	䴈,襖{(又)},拗{(文)},媼{老媼，媼嫗}
aau3	∅au55	噢{嘆詞},鿫,靿{靴靿},隩{通奧字},詏{(文)～蠻，勉強、將就、湊和},襖{棉襖，讀同懊},燠{甚熱},澳,擙,拗{(文)～蠻，勉強、將就、湊和},扷,懊{懊惱；懊悔},嶴,奧,墺,垇,坳{山坳；地名，高峯坳；手～，肘窩},圫
ai1	∅ɐi53	哎{(又)},唉{(又)}
ai2	∅ɐi33	矮
ai3	∅ɐi55	嫕,翳{遮蔽},縊,瞖{目瞖},曀
ai6	∅ɐi22	唉{(又)}
ak3	∅ɐk5	呃{(語)打～、打塞[ɬɐk5]～，打嗝},餩{(語)}
ak6	∅ɐk2	亦{(白)副詞，疊用，你去～得，我去～得}
am2	∅ɐm33	揞{(常)用手捂，～住},罯{(又)}
am3	∅ɐm55	窨{(白)漚，～草皮；釀，～甜酒}
an1	∅ɐn53	凐{寒貌},駰,闉,銦,諲,蒽,茵,絪,禋,甄{(又)讀同垔/堙},溵,湮{湮沒，湮滅},洇,氤,殷{殷勤；殷墟；姓},歅,慇,恩{恩德，報恩},姻,堙,垔,因
an2	∅ɐn33	㥯{謹也},隱,殷{雷聲},櫽,檃,摁{(語)～手模，按手印},䌥
an3	∅ɐn55	印,鮣,茚
ang1	∅ɐŋ53	㷫{(訓)熱（專指天氣），本字不明}
ang2	∅ɐŋ33	哽{～腳，硌腳}
ang3	∅ɐŋ55	嗯{(語)使勁憋，～屎，拉屎，象聲或啊嗯的合音},蹭{(白)～蹬[nɐŋ22]，頹笨、不開竅}
ap2	∅ɐp3	姶,腌{腌臢（不潔）},罯{覆蓋},搕{捂、敷，與揞對轉；合在一起漚，～草皮、～肥料}
at2	∅ɐt3	一{一定，第一；～定中[tʃœŋ55]、～定高升，猜碼口令，數字一},弌,壹
at3	∅ɐt5	噎{(語)打～鍬，打噴嚏}
au1	∅ɐu53	區{姓},鷗,謳,甌,熰{旱熱},毆{毆打，讀同歐},歐
au2	∅ɐu33	嘔{嘔吐},𠙶,黝{(白)深紫色（瘀血色），～血，瘀血，手捱打一捶變～喇，手被打一捶變紫了},塸
au3	∅ɐu55	慪{慪氣},熰{煖},漚{漚肥}
baa1	pa53	䰾,豝,蚆,葩{奇葩},芭,舥,羓,粑{餈粑，糌粑},笆,疤{傷疤，疤痕},巴{巴掌，尾巴},峇{峇厘島},岜,夿{奤夿屯},吧{酒吧，網吧；象聲詞},叭{象聲詞}
baa2	pa33	叭{喇叭},靶,鈀{金屬元素，符號Pd},把{把握；量詞，一把刀}
baa3	pa55	叭{象聲詞；唵嘛呢叭咪吽},霸{霸王，惡霸},爸{爸[pa21]爸，阿爸},灞,欛{刀～，刀柄},壩{堤壩},垻{平川}
baa4	pa21	叭{(語)象聲詞，啤[pi21]哩[li21]～啦[la21]，鞭炮聲、雨聲},鈀{同耙字，釘鈀},耙{犁耙，耙田},筢,琶{琵琶},爬,潖,杷{枇杷},掱,扒{扒手，扒草，扒龍船（劃龍舟）；牛～，牛排},巴{(語)下～，下頜，又作下扒}
baa5	pa24	㞎{㞎[pa21]～，屎，童語}
baa6	pa22	䶕,罷,吧{句末語氣詞}
baai1	pai53	䠋{蹟䠋},掰{掰開}
baai2	pai33	捭,襬{下襬},擺{擺放}
baai3	pai55	㗑,湃{澎湃，讀同拜},拜
baai4	pai21	俳,𥱼{竹排，又作簰/箄字},簰{同𥱼字},篺,箄{同𥱼字},牌,排
baai6	pai22	唄{唄唱，梵唄},韛,稗{稗官，稗草},敗
baak2	pak3	剝,趵{足擊聲；足擊},嚗{象聲詞；怒聲}
baak3	pak5	啪{(語)～子筒，噼啪筒，類似唧水筒，以溼紙團爲彈}
baak6	pak2	㩧{拍（翅膀），蒙鷹～翼},魄{(語)落魄},雹{冰雹，雹災},㼎
baam6	pam22	埿{同湴字，淤泥，爛～田，爛泥田},𦝤,湴{淤泥，爛～田，爛泥田，又作埿字}
baan1	pan53	攽,𨭉,頒,癍,瘢,班,斒,斑
baan2	pan33	坂,阪,闆{老闆},鈑,蝂,舨{舢舨，同舢板},版,板{黑板，石板，腳板薯},昄,扳{扳手}
baan3	pan55	𢲔{同𢴬字},𢴬{摔、摔打，俗字拌/絆/扮}
baan4	pan21	爿,𨂝{徒步涉水；爬},踫{同𨂝字}
baan6	pan22	扮,辦,瓣
baang1	paŋ53	乓{乒乓球},𠳐,邦,縍,浜{小河溝；沙家浜},梆,幫{幫助，丐幫，一幫}
baang2	paŋ33	嗙{自誇；吹牛},髈{同膀字},蒡{牛蒡},膀{肩膀，翅膀},綁,牓{同榜字；門牓},榜{張榜，榜樣}
baang3	paŋ55	搒{划船},謗{誹謗，謗議}
baang4	paŋ21	傍{傍晚},𩐨{(又)},龐{龐大，龐雜；姓},鰟{鰟鮍},雱,逄,蟛{蟛蜞；～鉗，小河蟹},螃{螃蟹},蒡{隱荵},膀{膀胱},篣,磅{磅礡},滂{滂沱},棚{草棚，棚架},旁{旁邊，兩旁},房{阿房宮},徬,彷{彷徨},嘭{(又)}
baang5	paŋ24	耪,蚌{蚌殼，河蚌，蚌埠市}
baang6	paŋ22	傍{依傍},鎊,稖,磅{過磅，磅秤},棓{棍、杖，後作棒},棒{棍棒，棒球},塝
baap3	pap5	卟{(語)用力甩、糊上，～泥上牆}
baat2	pat3	八{八卦，八仙，豬八戒；～匹馬，猜碼口令，數字八},朳,捌,扒{扒皮}
baat6	pat2	坺{同墢/垡字；塵貌},鼥,鮁,魃,跋{題跋，跋扈},菝,茇{草根},胈,炦{火氣},拔{拔河，選拔},妭
baau1	pau53	包{包圍，包括，麪包，打包},鮑{鮑魚；姓},褒{褒獎，褒貶},苞{花苞},胞{胞胎，細胞},煲{瓦煲，煲湯，一說本字釜/缹/鍑/褒，另一說英語boil},枹{枹樹},孢{孢子}
baau2	pau33	保,鴇,飽{吃飽，飽和},褓{襁褓},葆,寶,堡
baau3	pau55	儤,趵{跳躍；趵突泉},豹{虎豹，豹子},爆{爆炸，引爆，爆料，爆坼（裂開）},報
baau4	pau21	刨{削也；刨刀},麅,颮{風聲},鞄,鑤{同刨字},鉋{鉋刀},跑{獸用腳刨地},袍,袌{同袍字},稃{(白)～穀，秕穀；（植物子實）不飽滿；（木頭）內部不結實},狍,庖,咆{咆哮},匏{匏瓜}
baau5	pau24	抱,袌{同抱字}
baau6	pau22	暴{暴雨，粗暴},齙{(文)},骲{(文)},虣,菢{孵},爆{(又)爆炸，讀同暴},瀑{水名，瀑河}
bai1	pɐi53	㝿{(又)},𨃅{俗字，瘸，本字䠋},鵯,陂{山陂，陂塘},鎞{釵},跛{(訓)瘸，本字䠋},裨{裨益},萆{萆薢},羆,碑,椑{椑柿},悲,卑,䠋{(白)瘸，俗字跛}
bai3	pɐi55	背{(語)～時、～腏[tʃʰot2]，倒楣，又作閉時、閉腏[tʃʰot2]，官話借詞},閉{關閉，閉幕；巴～，辛勞}
bai5	pɐi24	蔽{(白)遮、擋，用手～住太陽}
bai6	pɐi22	坒,陛{陛下，階陛},鐾{鐾刀布，鐾刀},鎞{同篦字},薜{薜荔},篦{篦子，篦頭},箅{箅子},箄{漁具},狴,梐
bak2	pɐk3	北
bak3	pɐk5	擘{量詞，莢}
bak6	pɐk2	僰,踣,蔔{蘿蔔},菔{(又)},匐{(又)}
bam1	pɐm53	泵{(外)水泵，英語pump}
bam3	pɐm55	泵{(語)～水筒，竹製唧筒；沉水～，水泵}
bam4	pɐm21	韸{(語)象聲詞，獅子鼓響～～，獅子鼓砰砰響，呯呯～～，擬炮聲}
bam5	pɐm24	渢{(語)象聲詞，打水聲}
bam6	pɐm22	㽉{(語)裝米或酒的小口罈}
ban1	pɐn53	儐{尊敬},鬢{(常)俗讀，讀同賓},髕{髕骨，讀同賓},鑌,錛,邠,賓,賁{虎賁；姓},豳,臏{同髕字；孫臏},繽,玢{玉名},犇,濱,浜{同濱字},汃{同邠字},殯{(常)俗讀，讀同賓},檳{檳榔},栟{栟茶},斌,攽{(又)},彬,嬪{(常)俗讀，讀同賓},奔{奔跑；投奔}
ban2	pɐn33	稟{稟告，回稟}
ban3	pɐn55	儐{儐相},鬢{鬢角，兩鬢},殯{出殯，殯儀},擯{擯棄，擯除},捹{手亂貌；〈語〉旋轉，～螺[lo55]螺[lo55]，團團轉}
ban4	pɐn21	嬪{嬪妃},顰,頻{頻繁},貧,蘋{大萍},玭,瀕
ban5	pɐn24	牝
ban6	pɐn22	倴,笨{笨拙，蠢笨},坌{灰塵；聚集}
bang1	pɐŋ53	嗙{喝聲；嗙喻},鏰,蹦,繃{繃帶，緊繃，繃着臉},絣{振繩墨},祊,崩{崩塌，山崩},嘣{象聲詞}
bang3	pɐŋ55	堋{喪葬下土},繃{(白)詞綴，脹～～，脹鼓鼓}
bang4	pɐŋ21	凭{同憑字},鵬,鬅{鬅鬙；〈語〉～鬙[ɬɐŋ21]倰[lɐŋ21]，不整潔},馮{(古)暴虎馮河；通憑字},膨{膨脹},硼,澎,淜{淜湃},朋{朋友},搒{笞打},憑{憑據，文憑},彭,弸{弸弓},堋{分水堤壩},嘭{象聲詞，呯呤[leŋ21]～啷[lɐŋ21]，劈哩啪啦}
bang6	pɐŋ22	㼞{㼚屬},甏{甕},唪{(語)冚～唥，全部，一說本字𠊧；冚唪唥也是猜碼口令，數字十，也說開清手、全開手},凭{倚靠}
bap3	pɐp5	卟{(語)耷拉、垂下}
bap6	pɐp2	卟{(語)摺疊，～被；捲，～衫袖}
bat2	pɐt3	不{不能，不鏽鋼},𢳂{俗字，舀，本字撥，上古月部，另一說本字拂},饆,鈈,蹕,蓽,篳,筆{筆記，水筆（即自來水筆、鋼筆）},畢,珌{(又)},滭,泌{泌瀄},撥{(白)舀，上古月部，俗字𢳂，另一說本字拂},嗶,咇{咇㘉}
bat6	pɐt2	咇{(白)～～嚊[py24]嚊[py24]，囉唆、嘮叨},鼻{(白)鼻子，鼻涕},邲{古地名；姓},苾{苾苾},拂{通弼字},弼
bau4	pɐu21	垺{盛大},裒,浮{(白)～游踣掝[jɐk2]，工作不穩定，無工做而游逛},掊{聚斂},抔
bau6	pɐu22	培{培塿（小土丘）；〈語〉塿[lɐu22]～，不整潔、臃腫，古作培塿/部婁，俗字瘻婄/漏䏽}
be1	pe53	啤{啤酒，德語bier},巴{(白)～～坐，排排坐；～指，枝指},屄{(白)女陰，源自牝，谿谷也}
be4	pe21	巴{(白)詞綴，腍[nɐm21]～～，（肉類、瓜果等）軟爛},疤{(白)痲～，（臉上的）痲子、長痲子的人}
be5	pe24	㞎{(又)㞎[pe21]～，屎},痞{(白)發羊～，患羊角風}
be6	pe22	唄{語氣詞},蔽{(白)～篷，披身雨篷}
bem4	pɛm21	嘣{(語)象聲詞，啤[pi21]哩[li21]～咧[le21]，鞭炮聲}
ben2	pɛn33	匾{(白)牌匾，匾額},貶{(白)貶值，褒貶},藊{(白)},稨{(白)},扁{(白)扁擔，壓扁，扁桃體；打、揍，又作揙字}
ben4	pɛn21	平{(白)（簸箕等）底平}
ben5	pɛn24	緶{通辮字},辮{(白)髮辮，辮子}
bet3	pɛt5	泌{(白)象聲詞，擠射},癟{(白)乾～～，乾而收縮，不豐滿；軟～～，含水分多而軟；溼～～，溼淋淋}
bet6	pɛt2	咇{(白)嚊[pi22]嚊[pi22]～～，囉唆、嘮叨},癟{(白)腍[nɐm21]～～，（肉類、瓜果等）軟爛}
beu6	pɛu22	骲{(白)用力擠},齙{(白)齙牙}
bi1	pi53	屄{(文)吹牛屄（口語用扯大炮）},蓖{蓖麻}
bi2	pi33	䠋{同髀字},髀{大腿},譬{(訓)訓讀比},芘{有機化合物},舭,秕{秕子},畀{給，本地用許/與},沘,比{比較；比鄰，古讀去聲},彼{彼此，彼岸},媲{(訓)媲美又作比美，訓讀比},妣,吡{吡啶，吡咯},俾{使},佊{不正}
bi3	pi55	匕,閟,鉍,鄪,邲{好貌},轡,賁{賁臨},費{費縣},詖,芘{通庇字},臂,肸{古地名},秘{秘魯；同祕字},祕{祕書，祕密；姓},痺{痹的俗字},痹{麻痹},潷{擋住渣滓，把液體倒出},泌{分泌，泌尿；地名，泌陽（在河南）},毖,庇{包庇，庇護}
bi4	pi21	啤{(語)象聲詞，～哩[li21]嘣[pɛm21]咧[le21]，鞭炮聲，～哩[li21]叭[pa21]啦[la21]，鞭炮聲、雨聲},鼙,鮍,陴,陂{地名，黃陂（在湖北）},鈹{金屬元素，符號Be},鈚{犁錧別名},郫,邳,貔,裨{裨將},蠯,螷,蜱,蚍,芘{芘芣},膍,脾,紕{飾緣邊也},皮,疲,琵{琵琶},毘,毗,椑{椑榼},枇{枇杷},埤{埤益}
bi5	pi24	被{棉被，植被}
bi6	pi22	備{準備，備用},鼻{(文)},髲,骳,鞴,鞁,陛{(又)},避,贔,被{被動},蔽{隱蔽，讀同敝},糒,狴{(又)},梐{(又)},斃{槍斃，斃命},敝{凋敝，敝人},憊{疲憊，讀同備，古讀蒲拜切},弊{作弊},庳{房屋矮小；低窪；有庳},幣{貨幣，錢幣},婢{婢女},奰,埤{低溼地},坒{(又)},嚊{喘息聲；〈語〉～～咇[pɛt2]咇[pɛt2]，囉唆、嘮叨}
biak2	piɐk3	伯,蘗{(文)},薜{當歸；山麻},百,檗{(文)},柏{(文)},佰
biak6	piɐk2	帛{玉帛，帛書},鮊,白
biang3	piɐŋ55	柄{(白)名詞，刀～}
biang4	piɐŋ21	平{(白)便宜}
biang5	piɐŋ24	並{(白)～骨，（豬牛羊等的）肋骨、排骨},抨{(白)驅趕，與拍對轉}
bik2	pek3	偪,鰏,逼,迫{(罕)訓讀逼},躄,襞,腷,碧,皕,璧,煏{火勢逼人，火太～多；～馬筒，子彈殼、子彈筒},湢{浴室},愎,愊,壁
bin1	pin53	煸{(又)},鯿{鯿魚},鞭,邊{旁邊，邊緣},蝙,萹{萹蓄},籩,箯,砭{鍼砭},甂{打～爐，打火鍋}
bin2	pin33	匾{(文)},貶{(文)},褊{褊狹},藊{(文)},窆,稨{(文)},碥,扁{(文)}
bin3	pin55	變
bin4	pin21	㛹,𡎚,骿,駢,蹁{足不正},跰,諞{巧言},褊{褊褼},胼,緶{用針縫},楩,便{便宜，大腹便便}
bin5	pin24	緶{(又)},辮{(文)},諞{誇耀}
bin6	pin22	便{方便，便利，順便，隨便},𨚕,邲{水名},辯,辨,苄,汴,昪,抃,忭,弁,卞
bing1	peŋ53	乒{乒乓球},栟{栟柑，栟櫚},掤,并{并州},屏{屏營},冰,兵
bing2	peŋ33	丙,餅,鉼{餅狀金屬塊},邴,蛃,秉,炳,昺,屏{屏除，屏息}
bing3	peŋ55	並{(又)},迸{迸裂},竝{(又)},柄{(文)量詞，把},摒{摒棄，摒除},并{同併字，合併；〈又〉同並字，並且},併{合併，併入}
bing4	peŋ21	呯{象聲詞，～呤[leŋ21]嘭[pɐŋ21]啷[lɐŋ21]，劈哩啪啦，～～韸[pɐm21]韸[pɐm21]，擬炮聲},鮃,鉼{古地名},評,蚲,蘋{蘋果},蓱,萍,荓,苹{同萍字；藾蕭},缾,瓶,玶,洴,泙{水名},枰,平{和平，平坦},帡,屏{屏風},坪
bing6	peŋ22	並{並且，並行，兼容並包},竝{並的本字},病,并{同並字，並且}
bit2	pit3	佖,𥷑,鼈,鱉{魚鱉；吹風～，眼鏡蛇},鉍{(又)},觱,珌,憋,必,彆{彆扭},咇{咇茀}
bit6	pit2	䏟{肥肉也},馝,蹩{蹩腳},苾{菜名},癟{癟陷；癟三},別{離別；區別}
biu1	piu53	䅺{稻田秀出者；〈語〉冒出，～芽，發芽},髟,驫,驃{黃白色的馬},飆{狂飆，飆車，發飆},颮{同飆字},鑣,鏢,錶{手錶},藨,蔈,臕{肥臕},膘{肥膘},穮{除草},瘭,猋{犬奔貌；通飆字},熛{火飛},瀌{雨雪瀌瀌},滮{水流貌；迸射，痛得我眼淚～},標,杓{勺子柄},摽{揮去；拋棄},彪,幖,儦
biu2	piu33	俵,裱,表{表面},脿,婊
biu3	piu55	嫑
biu4	piu21	剽,薸,瓢{水瓢；～羹，羹匙},朴{姓},嫖{嫖賭；～騇，嫖妓，俗作嫖舍；案，嫖字分音作皮條}
biu5	piu24	慓,莩{同殍字},殍,摽{落下；緊捆綁}
biu6	piu22	鰾{魚鰾（口語稱魚泡[pʰau55]）}
bo1	po53	啵{象聲詞；助詞},𨨏,菠{菠菜，菠蘿},般{般若},磻{繳矢所用石塊},玻{玻璃},波{波浪；〈外〉球，～鞋，英語ball},嶓
bo2	po33	㝿,跛{跛足},簸{(又)往地上摔砸，～碗～碟；～三萬，一種遊戲，用一文銅錢向空中拋，猜哪一面向上賭輸贏}
bo3	po55	噃{粵字，語氣詞，本地用喎，噃已不用，一說喎本爲噃的弱讀},蕃{吐蕃},播
bo4	po21	簸{(語)～梭[ɬo21]邏，樹冠覆蓋面大，遮陽好}
bo6	po22	薄{薄荷，又作蔢𦽅}
boek3	pœk5	㩧{敲、砸，要石頭～渠，與𢷕旁轉}
boek6	pœk2	幞{(又)},襆{(又)},穙{(白)量詞，把、串，兩～，兩串，與唪對轉},樸{木名；～子，柚子}
boeng2	pœŋ33	玤,菶{菶菶},甭,琫
boeng4	pœŋ21	塳{塵也},髼{髮亂},韸{鼓聲},逢{鼓聲；姓},蓬{蓬勃，蓬鬆},芃,篷
boeng6	pœŋ22	䭰,𩗴,埲{塵起貌},唪{大笑也；〈量〉簇、串，一～葡萄，與穙對轉，疑本字菶，另一說源自朋}
bot2	pot3	𠼭{(又)},𡀖{(又)}
bot5	pot24	𦤣{(語)又音}
bot6	pot2	𦤣{(語)屁聲}
bu1	pu53	峬,餔{申時食也},鈽,逋,晡,庯
bu2	pu33	埔{黄埔，大埔},補
bu3	pu55	㘵,餔{餹餔，餔子},怖{恐怖},布{布匹，紅布},佈{佈置，佈告}
bu4	pu21	匍{匍匐},酺,鄱,蒲{菖蒲，蒲公英},蒱,葡,菩{菩薩，菩提},莆{莆田；姓},脯{胸脯},繁{姓},皤,浮{(白)浮頭，浮薸},婆{阿婆（外祖母），老婆（妻子）}
bu5	pu24	捕{(白)～燈蟲，飛蛾},秿{(白)蚊蠅麇集}
bu6	pu22	哺{(又)本讀},鵏,部,蔀,簿,步,捕{(又)本讀},埠{步的分化字，埠頭，船埠；鄉鎮地名，石埠},埗{同埠字；地名用字}
bui1	pui53	杯,誖{(語)吹捧、哄，或爲捧吹的合音},盃{獎盃},桮
bui3	pui55	唄{用於人名、物名、地名，讀同貝，地名多見於西藏、雲南、湖南等省},鋇,邶,輩,貝,褙,背{背脊，後背，背陰，背風},狽,浿,梖,揹{同背字，揹負，揹槍}
bui4	pui21	培{培養，培植},陪,錇{化學元素},賠,裴,毰{毰毸},徘
bui5	pui24	倍,蓓,碚,棓{五棓子}
bui6	pui22	孛{彗星},鐾{(又)讀同背},誖{言亂},苝,背{背書，耳背，背靜},焙{焙乾},悖
buk2	pok3	㬍{暴也},髆{肩胛骨},駁,餺{餺飥},鎛,膊{胳膊，肩膊；～頭，肩膀，～布，挑擔時肩上墊布},縛{(又)讀同博},猼{猼訑},欂{欂櫨},搏{搏鬥，脈搏；～抵，佔便宜，～懵、～亂，趁機、渾水摸魚},壆{壟},博,亳
buk3	pok5	㿺,𦢊{泡、皰，又作泡/㿺字},泡{(語)泡，豆腐～、魚～；皰，又作𦢊/㿺字}
buk6	pok2	泊{(文)淡泊，漂泊，落泊},魄{(又)落魄，又作落泊/落薄},鉑,薄{厚薄},舶{(文)},箔,礴{磅礡},礡,濼{同泊字}
bun1	pun53	搬,般{一般，百般}
bun2	pun33	本,苯,粄,畚
bun3	pun55	半,靽,絆
bun4	pun21	柈{同槃/盤字},蹣{蹣跚},蟠,般{般樂},胖{心廣體胖},磻{磻溪},磐,盤,盆,湓{水涌；水名},槃
bun5	pun24	伴{伴侶，作伴，伴隨，陪伴},胖{肥胖},拌{攪拌，拌嘴，本字秚}
bun6	pun22	叛{(又)},秚,畔{湖畔，江畔},泮{同畔字；地名，泮塘村（在橫縣），泮塘（在賓陽縣）},柈{柈子}
bung2	poŋ33	榜{(常)}
bung5	poŋ24	渢{(語)象聲詞，打水聲}
but2	put3	砵,𡀖{汽笛聲；～～車，汽車，童語},𠼭{同𡀖字},鱍,鉢{鉢盂，衣鉢},缽{同鉢字}
but6	put2	勃,𦤣{臭敗氣},𡋯{𡋯土},鵓,馞,餑{麪餑},鈸{銅鈸，鐃鈸},襏,葧,荸{荸薺（源自葧臍，口語稱馬蹄）},脖,潑{(又)活潑，讀同撥},渤,浡,桲,撥{撥開，點撥},孛{同勃字；姓},哱
byu5	py24	嚊{(語)咇[pɐt2]咇[pɐt2]～～，囉唆、嘮叨}
caa1	tʃʰa53	叉,蹅{踏},杈{枝杈，枒杈},搓{(白)搓手，揉搓},扠,差{差別，誤差},喳{擬人聲，嘁嘁喳喳，打喳喳}
caa2	tʃʰa33	鑔{小鈸，也泛指鈸}
caa3	tʃʰa55	㤞,詫,衩,汊,岔{岔路},奼,侘
caa6	tʃʰa22	欻{(語)菜入熱鍋聲，或源自灹，火聲}
caai1	tʃʰai53	偲{多才},釵,猜,搋{搓揉，～麪},差{出差},啋
caai2	tʃʰai33	䐆,采{文采，神采},踹{踩},踩{踩踏，本字跐；〈語〉～母，禽類交配},跴{同踩字},跐{(白)俗字踩},茝{香草名},綵{剪綵，綵球},睬,採{採摘，採取},彩{光彩，彩色},寀,䦟
caai3	tʃʰai55	啜{姓},蠆,蔡,菜,縩,瘥{病癒},棌{棌樹},埰{埰地},嘬{咬；吃}
caak2	tʃʰak3	剒
caam1	tʃʰam53	參{參加，參觀},驂,辿{(又)},攙{攙扶},摻{摻雜，摻水；同攙字}
caam2	tʃʰam33	噆{銜也},黲,篸{撮箕，～箕},穇{穇子},朁,旵,摻{執持},憯,慘
caam3	tʃʰam55	儳{儳言},杉{杉樹，杉木},摻{鼓曲名},懺{懺悔},忏
caan1	tʃʰan53	餐
caan2	tʃʰan33	䊲,鏟{鑊鏟；鏟走，鏟除},產,滻,剷{剷走，剷除},剗
caan3	tʃʰan55	孱{孱頭},薒,羼,粲,璨,燦
caang1	tʃʰaŋ53	䱽{同鯧字},鶬{鶬鶊},鯧{(習)鯧魚，俗字䱽},蒼,艙,窗{窗戶，門窗},瘡,滄,傖,倉
caang2	tʃʰaŋ33	厂{同廠字},駔{駔子（流氓）},闖{闖入，闖禍},鋹,氅,橙{橙子，橙色，橙樹},昶,敞,惝,廠
caang3	tʃʰaŋ55	刱,闖{撞，～爛，～倒，～見},愴,創{創造；創傷，古讀平聲}
caap2	tʃʰap3	㮑{木折聲},𠝞{切物聲},鍤,臿,插,扱{插；挹取}
caat2	tʃʰat3	㔍{斷也；割斷聲},礤,獺{水獺，海獺，又作𤞠字},涮{(又)讀同刷/擦},欻{急促的聲響},檫,攃{摩擦，後作擦},擦{擦拭，摩擦，本字攃},察,嚓{象聲詞，啪嚓，喀嚓},唰{象聲詞},刷{刷牙},䃰
caat6	tʃʰat2	擦{(語)白剌[lat2]～，蒼白，前字調類化，元曲寫法}
caau1	tʃʰau53	剿{同抄字，剿襲，剿說},𤙴{牴},鈔{鈔票，現鈔；同抄字},操{操作，體操；操守，古讀去聲},摷{取},抄{抄書；翻找、亂翻}
caau2	tʃʰau33	㥮{(又)},騲{騲雞},草,炒{炒飯，炒菜},懆,吵{吵鬧，爭吵}
caau3	tʃʰau55	噪{噪聲},𥖨,躁,譟{譟動，鼓譟},肏{北方俗字，詈語，摹官話音，本字戳，肏本音入},耖,糙{粗糙，糙米},燥,氉,慥{(又)}
cai1	tʃʰɐi53	凄,郪,萋,淒{淒涼},棲{棲息；棲棲},栖{同棲字},悽{悽慘},妻
cai3	tʃʰɐi55	傺,磜{(又)},砌,瘛{瘛瘲},沏{沏茶},憏,切{一切}
cak2	tʃʰɐk3	廁{廁足},測,惻
cak3	tʃʰɐk5	吒{(語)象聲詞，要米筒～啲米出來，將米筒裏的米抖出來}
cak6	tʃʰɐk2	蠈,鰂{烏鰂，即烏賊},賊{做賊，賊佬}
cam1	tʃʰɐm53	侵{侵佔，入侵，侵略},駸,諃,祲{(又)},棽,摻{(白)～油、～水、～沙，俗字侵},嵾,參{參差，俗讀參加之參}
cam2	tʃʰɐm33	寑,鍖{鍖銋},踸,趻,磣{牙磣，寒磣},梫,寢
cam3	tʃʰɐm55	吣{貓吣，胡吣},讖,譖{(又)},謲{怒也},滲{(白)滲入，滲透},唚{同吣字，貓唚，胡唚}
can1	tʃʰɐn53	伸{(白)～手，～懶腰，～直，又作抻/胂字},鶉{鵪鶉，古讀常倫切},鰆,逡,踆{踆踆，踆烏},親{親切},蝽,膥{俗字，禽魚蝦之卵，本地不用，而是用蛋，廣東粵客多用，廣西罕用，僅限部分地區，一說避諱亂，改用伸/抻/春},胂{伸身也},瞋,皴{皴裂},瑃,椿{椿樹},春,捵{同抻字},抻{拉、扯（物），抻麪；同伸字},堾{石壘擋土牆；地名用字},嗔{生氣}
can2	tʃʰɐn33	哂{哂笑},鬒,辴,蠢{愚蠢，蠢材},矧,疢{(又)}
can3	tʃʰɐn55	櫬,齔,趁{趁機，趁早，趁墟（趕集）},親{親家},襯,疢
cang1	tʃʰɐŋ53	噌{噌吰}
cang3	tʃʰɐŋ55	撐{(又)張開，～傘、～眼},蹭{磨蹭；蹭蹬}
cap2	tʃʰɐp3	咠,輯{編輯，輯錄},蕺,葺,緝{緝拿，緝鞋口},楫{通輯字，聚也；〈又〉舟楫，讀同咠/輯},戢{戢兵，斂戢；姓}
cap3	tʃʰɐp5	㮑{(白)脆～～，（蘿蔔等）非常脆，俗字戢},戢{(語)脆～～，（蘿蔔等）非常脆，本字㮑}
cat2	tʃʰɐt3	䢺,齣{一齣戲},黢{黢黑，黑黢黢},黜{罷黜，黜退},詘{同黜字},猝{倉猝，猝然},焌{使火熄滅；一種烹調法},漆,桼,柒{七的大寫},怵,卒{(古)通猝字},出{出去，外出},七{第七，七夕；～巧[kʰiu33]、～財、～子團圓，猜碼口令，數字七}
cau1	tʃʰɐu53	抽,鶖,鰍,鞧,鞦{鞦韆，牛鞦},萩,紬{紬繹},篘,秋{秋天},瘳,湫{水潭},楸,搊{搊起來},掫{拿取東西}
cau2	tʃʰɐu33	丑{子丑},醜{醜惡},矁,瞅,杻{古刑具，似手銬},偢{同瞅字},侴
cau3	tʃʰɐu55	嗅{嗅覺；用鼻聞},齅,輳,蔟{太蔟},臭{臭味},腠,糗{乾糧},溴,湊{拼湊，湊數；連詞，和，我～你講一件事；介詞，向，～渠借一本書},殠
ce1	tʃʰe53	俥{船上動力器；掌船動力器者，大俥},車{車輛},硨
ce2	tʃʰe33	且,跙{足利；〈語〉走開、離去，俗字扯},撦{同扯字},扯{拉扯，扯皮；～大炮，吹牛},尺{工尺},奲{寬大也；奲都}
ce3	tʃʰe55	唓{唓嗻；語氣詞，表輕蔑；～咧[le55]，話多、愛表現，源自啁嘐/嘐啁，語多},趄{傾斜；趔趄},笡{斜、陡}
ce4	tʃʰe21	斜{(又)}
cem1	tʃʰɛm53	鵮{鳥啄物；〈語〉鵝鴨等扁嘴類動物取食}
cen2	tʃʰɛn33	剷{(白)},鏟{(白)鏟兒}
cet3	tʃʰɛt5	設{(語)詞綴，短/薄/坽[leŋ55]～～，短/薄/陡貌；案，設設爲元曲寫法}
ci1	tʃʰi53	呲{斥責},齹{齒參差},齝,黐{黏、粘},鴟,魑,髊,骴,飺,雌{雌雄，雌蕊},郗{姓},誺{不知},蠀{蠀螬},螭,蚩,胵{膍胵},絺,笞,眵{眼眵},眥{睚眥，讀同疵},癡{癡情，白癡；〈語〉蠢、傻、瘋},痴{同癡字},疵{瑕疵，吹毛求疵},瓻,玼{玉的疵點},摛,差{參差，俗讀差別之差},媸,嘁{嘁嘁喳喳},嗤{嗤笑},哧{象聲詞}
ci2	tʃʰi33	佌,齒,鮆{魚名},鉹,跐{踏；跐豸},誃{離別},褫,胣,玼{鮮明},泚,此,恥,恀,姼{(又)},哆{張口},侈{奢侈}
ci3	tʃʰi55	伺{伺候，伺機},饎,跮{跮踱},賜,覗,蛓,蚝{同蛓字},莿,胵{(語)腑[fu21]胵，家禽內臟，炒腑～、腑～湯，俗作扶翅/芙翅},翨,翅,絘,笥,眙{直視},痓,熾,次,朿,廁{廁所},庛,幟{旗幟},啻,刺{魚刺，刺刀，行刺},儩,佽,佁{佁儗},佀,似
ci5	tʃʰi24	恃{(語)仗恃，～住官大；仗勢欺人的，～一世}
ciak2	tʃʰiɐk3	㪕{㪕起棍子},鵲{喜鵲},雀{偷飯～，麻雀；打麻～，打麻將},逴,踔,蓛,綽{寬綽，綽號},粣{糉也},簎{刺也},箣,策,碏,焯{略煮一下，～菜},淖{同綽字},棤{(又)},柵{柵欄},拆{拆開},婼{不順從},婥,坼{裂開},咤{叱咤，同叱吒},吒{叱吒},冊,䜺{豆䜺},㿭{皴}
ciang1	tʃʰiɐŋ53	倀{爲虎作倀},鶬{鶬鶬；金飾貌},鯧{(書)},閶,鐺{通鎗字，酒器；平底煎鍋},鏘,鎗{鐘聲也；酒器；同槍字},錆,蹡{行貌},蹌{動也；蹌蹌，舞貌},菖{菖蒲},箐{竹名},瞠{瞠目},瑲,猖,牚{同撐字},橕,槍,昌,撐{撐船，支撐},搶{以頭搶地},戧{逆},將{請也，將子無怒},娼,嗆{吃飯嗆着},倡{倡優}
ciang2	tʃʰiɐŋ33	搶{搶奪}
ciang3	tʃʰiɐŋ55	倡{提倡，倡議},鬯,韔,鋥{鋥光，鋥亮},蹡{踉蹡},蹌{踉蹌},瑒{祭祀之圭},牚{椅子牚},熗{一種烹飪方法，熗菜，熗鍋},暢{通暢，暢快；〈語〉破開，～散紙，將大額鈔票破開},撐{(又)撐場，硬撐（結實；案，元曲作硬掙），讀同牚},戧{撑},悵,嗆{油煙嗆人},唱{唱歌，歌唱，唱衰}
cik2	tʃʰek3	刺{(白)刺骨，頭刺（頭痛），肉刺（心痛）},鶒,飭,鏚{鏚斧},赤{赤色，赤子，赤口日；打～膊，赤膊，打～腳，赤腳},槭{槭樹},斥,敕{宣敕，敕命},抶,戚{親戚；姓},慽,慼{悲慼},彳,尺{尺寸},呎,叱{叱吒，呵叱}
cim1	tʃʰim53	䙴{同遷字},錟{同銛字，鋒利},鋟,銛,鉆{鑷子},釺{(習)禾～擔竿，兩頭尖的扁擔，挑稻草、茅草用},遷{(習)遷移，遷徙},襜,纖{纖細},籤{抽籤，牙籤},籛{馬具；姓},簽{簽字，簽收},箋{(習)便箋，信箋，讀同籤},牋{同箋字},殲{殲滅},櫼,憸{憸佞，憸邪},孅,嬐,僉
cim2	tʃʰim33	諂
cim3	tʃʰim55	僭,韂,槧,暹{暹羅},塹
cin1	tʃʰin53	䙴{(又)},韆{鞦韆},阡{阡陌},釺{(書)},遷{(書)},躚{蹁躚，讀同千},芊{芊綿，芊芊},籛{(又)},牋{(又)},梴{木長貌},杄,扦{扦子，扦插},圲,千{萬千，千金},仟{千人之長；千的大寫}
cin1 mai5	tʃʰin53 mɐi24	粁
cin1 waa5	tʃʰin53 wa24	瓩
cin2	tʃʰin33	嘽{寬舒},闡{闡述，闡明},蕆,燀{炊},淺,囅
cin3	tʃʰin55	倩{(又)}
cing1	tʃʰeŋ53	偁{同稱字},鯖{魚名},青{青草，青菜（綠葉蔬菜總稱）},赬,蟶{蟶子},蜻{蜻蜓},虰{虰螘},稱{稱呼},清{清理，水清},氰{(又)讀同青},檉,圊,僜{醉行貌}
cing2	tʃʰeŋ33	庱,騁,請{請客，邀請，請假}
cing3	tʃʰeŋ55	掅{揪住},稱{稱心，相稱},秤{桿秤，秤砣},碃
cip2	tʃʰip3	唼{唼佞},妾
cit2	tʃʰit3	切{切開},竊,沏{水聲}
ciu1	tʃʰiu53	幧,鍬{鐵鍬；〈語〉打噎[ɐt5]～，打噴嚏},釗,超,繰{繰邊},炤{同昭字},昭{昭然，昭雪，王昭君，展昭},悄{靜悄悄},怊,弨
ciu2	tʃʰiu33	悄{悄然},愀
ciu3	tʃʰiu55	俏,鞘{刀鞘},誚,肖{生肖，肖像},帩,峭,偢{傻偢}
co1	tʃʰo53	嵯,蹉{蹉跎},磋{切磋，磋商},瑳,搓{(文)}
co3	tʃʰo55	剉,錯{錯誤，過錯；交錯，古讀入聲，倉各切},銼,莝{莝草},措{措施},挫
coek2	tʃʰœk3	亍,𦌊,齪{齷齪},餗,閦,速,蹴,蹙,踧{踧踖},諔,觸,觫,触,蔟{蠶蔟},蔌,蓄{儲蓄},簌{簌簌},簇{簇擁，簇新，一簇},築{建築},筑{古代弦樂器},矗,畜{畜生；畜牧},琡,滀,涑,束,斶,搐,俶{始也；整也},促{督促，促進}
coeng1	tʃʰœŋ53	㳘,驄,鏦,衝{衝鋒},蔥{蔥花，洋蔥},蓯,葱{同蔥字},茺,艟{(又)本讀},舂{舂米；～坎，石臼},聰,翀,璁,瑽,珫,熜{微火；熱氣},涌{小河，一說本字潨；地名用字，廣東多用，廣西多作沖/埇，皆同源},沖{沖洗，沖茶；地名用字，竹排沖（又稱竹排坑、竹筏坑），廣東多作涌/埇，廣西也有作埇，皆同源，一說本字潨},樅{冷杉},摏,憧{憧憬},怱,忡,埇{地名用字，兩廣多用，與地名用字涌、沖同源},囱{同囪字},囪{煙囪},匆{匆忙，匆匆},充
coeng2	tʃʰœŋ33	冢{枯冢},寵,塚{同冢字},埫
coeng3	tʃʰœŋ55	揰{推擊},𥅻,銃{火銃},蹱{(又)}
con1	tʃʰon53	汆{汆丸子，汆湯}
con3	tʃʰon55	篡
cot6	tʃʰot2	戳{(語)男陰，戳物的合音，假借字腏；詈語，～頭，既指男陰又指爛人；後綴成分，～死，要死，貴～死，貴得要死；程度副詞，老～屎，年紀不大卻裝老成、自作聰明},腏{(語)假借字，男陰，戳物的合音，俗字戳；詈語，～頭，既指男陰又指爛人；後綴成分，～死，要死，貴～死，貴得要死；程度副詞，老～屎，年紀不大卻裝老成、自作聰明}
cu1	tʃʰu53	初,麤,觕,粗
cu2	tʃʰu33	取{(白)助詞，動詞後表動作方式，着},齼,脞,礎{基礎},濋,楚,憷,娶{(白)娶老婆}
cu3	tʃʰu55	厝,醋,酢{酢漿草；同醋字},瘄
cui1	tʃʰui53	催,衰{(古)減也；同縗字，齊衰},縗,璀,獕,炊,榱,摧,崔{姓},嗺,吹{吹噓，吹奏}
cui2	tʃʰui33	揣{揣度，揣摩},膪{囊膪（口語稱泡[mau53]囊[naŋ53]肉）},漼
cui3	tʃʰui55	啐{嚐；唾聲},萃,膵{膵臟，膵液},膬,脺,脆,翠,綷,粹{純粹},瘁,焠,淬,毳,悴
cuk2	tʃʰok3	戳{戳穿；郵戳},齪{(常)俗讀},鐲{手鐲，鐲子（口語稱軛/鈪）},擉{剌也}
cun1	tʃʰun53	村,鑹,邨,躥{(又)跳；～戇[ŋaŋ55]戇[ŋaŋ55]，踉踉蹌蹌}
cun2	tʃʰun33	忖
cun3	tʃʰun55	吋,躥{跳；〈語〉囂張},竄{流竄，竄逃},爨,攛,寸
cut2	tʃʰut3	撮{一撮，撮合}
cyu1	tʃʰy53	坥,趨,趍{同趨字},貙,蛆{生蛆},芻
cyu2	tʃʰy33	取{爭取，取消},處{相處，處理},杵{舂杵，杵臼},娶{娶親，嫁娶}
cyu3	tʃʰy55	處{處所，到處，處暑},趣,覷{小覷，面面相覷},覰
cyun1	tʃʰyn53	川,穿,氚
cyun2	tʃʰyn33	喘,踹{足跟},踳{同舛字},舛,堾{同踳字}
cyun3	tʃʰyn55	串,釧
cyut2	tʃʰyt3	㬚,設{建設，設計},澈,撤,掣{(又)本讀},徹,屮
daa1	ta53	咑{叱驢馬聲},打{(外)量詞，十二個，英語dozen}
daa2	ta33	打{擊打，打球}
daa3	ta55	咑{(語)象聲詞，嘟[tu55]嚕[lu55]～喇[la55]，東西掉落聲}
daa5	ta24	柁{同舵字},舵{舵手，掌舵}
daai1	tai53	呆{書呆子，癡呆，本字懛；〈又〉呆板},獃{書獃子，癡獃，本字懛；〈又〉獃板},懛{懛獃}
daai2	tai33	傣{傣族},歹
daai3	tai55	帶{帶領，鞋帶},襶{(書)},戴{戴帽，愛戴；姓}
daai4	tai21	儓,鮐,駘{劣馬},颱{颱風},邰,跆,薹{蒜薹},苔{青苔},臺{平臺，臺階},炱,檯{櫃檯，檯面},枱{同檯字},擡{擡頭，擡高},抬{同擡字},台{兄台；台州，天台山}
daai5	tai24	柁{(白)},舵{(白)掌舵，俗字舦}
daai6	tai22	代{代表，交代},黛,駘{駘蕩},靆,迨,軑,貸{(又)},詒{欺詐},袋,紿,甙,玳,汏{洗},殆,怠{怠慢，怠工},待{等待，擔待},岱,大{大小，大夫，大蒜},埭{(又)},垈
daak3	tak5	咑{象聲詞；俗字，嘞[lak5]～，不整潔，本字肋脦},脦{(語)肋[lak5]～，不整潔，俗字嘞咑}
daak6	tak2	凙,鐸,踱,度{量度，揣度}
daam1	tam53	儋,鵮{(文)},頕,躭,覘{擡頭},聃,耽{耽誤，耽湎},眈{虎視眈眈},擔{(動)擔任，承擔，擔心}
daam2	tam33	紞{冕前垂者},膽
daam3	tam55	帎{冠俯前},擔{(名)擔子，扁擔（口語稱擔竿）}
daam4	tam21	倓{倓然},𧽼{走貌},鐔{古兵器，似劍而小；姓},錟{長矛},醰{醇厚},郯,譚,談,覃{覃思；姓},蟫{蠹魚},蕈{植物名},蕁{知母草},罈{酒罈},磹{地名，磹口（在福建）},痰{吐痰，痰盂},燂{燒熱；〈語〉火燻，屋～灰},澹{澹臺（複姓）},潭,曇,惔{火燒},壜,埮{同壜字}
daam5	tam24	氮,淡{清淡，淡泊，淡季，淡定（澹定）；地名，淡村}
daam6	tam22	䐺{肥貌，與𦛚旁轉},黮{黑色},髧{髮垂},賧,萏,窞{深坎},澹{澹泊，恬澹；澹定，俗作淡定},欿{坎欿},憺,惔{通憺字},埮{地平而長},噉{同啖字},啿,啗,啖{吃；姓；〈量〉口},倓{通賧字}
daan1	tan53	丹,鄲,襌,簞,癉{火癉},殫,單{單獨，孤單；～丁，孤單、單獨}
daan2	tan33	撢{同撣字},疸{黃疸},撣{雞毛撣子}
daan3	tan55	䋎{(語)俗讀，～被，釘被子；～被針，釘被子的針；因聲旁旦讀同旦},鉭{(又)},誕,癉{勞病；憎恨},旦{元旦，花旦}
daan4	tan21	壇{花壇，論壇},檀,彈{彈琴，彈指，彈簧}
daan6	tan22	亶{同但字},蜑{蜑家，蜑民，俗字疍},蛋,膻{膻中},疍{疍家，疍民，本字蜑},燀{熱甚；過度},澶{澶漫},泹{俗字，焯水},憚,彈{子彈，彈弓},僤,但
daang1	taŋ53	噹{啷噹},鐺{鋃鐺},襠{褲襠，開襠褲},蟷,簹,當{應當，當時},璫
daang2	taŋ33	党{党項；同黨字},黨,讜,欓,檔{檔案，檔次，高檔},攩,擋{阻擋},壋
daang3	taŋ55	壋{(又)},譡{諰[ɬai53]～，奚落諷刺人},當{典當，當作，適當},檔{攤檔，拍檔},擋{摒擋}
daang4	taŋ21	䣘,餳{同餹字},鏜{加工零件之法},醣,鄌,赯,螳{螳螂（口語稱馬螂扛）},螗,茼{(又)茼蒿，又作塘蒿},膛,糖,瑭,溏,樘,棠,搪,塘,堂{廳堂，堂兄；量詞，一堂課},坣,唐
daang6	taŋ22	宕{跌宕，延宕},蕩{遊蕩，放蕩；〈語〉樹～，樹的根鬚},菪,碭,盪{盪漾，盪滌},璗
daap2	tap3	䐛,鎝{翻土農具},褡,耷{大耳},答,瘩{瘩背，疙瘩},疸{疙疸，即疙瘩},溚{溼，溼溚溚},撘{同搭字},搭
daap3	tap5	嗒{嘀嗒；咂嘴聲，響～～，與啖對轉}
daap6	tap2	䂿{舂已復擣之},闒{樓上戶},遝,蹋,踏,沓{一沓紙，紛至沓來},嚃{(又)}
daat2	tat3	㟷{屹㟷，同圪墶},𢴈{俗字，摔，本字躂},靼,躂{(白)摔倒，～班，留級、蹲班；躺倒；用力摔，該義又作撻字},笪{竹笪，洞～，茓子},炟,撻{(語)用力摔，本爲躂的引申},怛{慘怛，怛惕},妲{妲己},墶{圪墶}
daat3	tat5	噠{(語)裂開近乎斷}
daat6	tat2	䃮,鐽,達{到達},薘,繨,噠{象聲詞}
daau1	tau53	刀,𣱼,魛,舠,氘,忉,叨{嘮叨}
daau2	tau33	倒{倒塌，顛倒；倒立；～瓤，瓜類過熟},禱,擣,搗,島
daau3	tau55	倒{倒掛，倒退，倒水；～矴[teŋ55]，倒置},捯,到{到底，達到；見到，知到}
daau4	tau21	䄻,鼗,騊,鞀,陶{陶冶，陶器},錭{(語)銼},醄,逃,萄,綯{拴，亞隻牛～住木根腳},燾{人名用字},濤,淘{淘米，淘氣},洮{盥洗},檮,桃,掏{掏錢},啕,咷,匋
daau6	tau22	導,道{道路，大道；知道（口語用知到，動補結構）},蹈,纛,稻,盜,燾{覆蓋},悼,幬{覆蓋}
dai1	tɐi53	低{高低，低頭},鞮,羝,磾,氐{氐羌；氐宿},彽
dai2	tɐi33	厎{(又)},骶,阺,邸,詆,砥,牴{牴觸，牴牾},氐{古同柢},柢{根柢},抵{抵押，抵抗；～值，划算、值得，～恁，能忍受、吃得虧，搏～，佔便宜},底{底部，水底},坻{寶坻縣}
dai3	tɐi55	䟡{蹋也},𤧛,諦{真諦，諦視},螮,蒂,締,禘,碲,渧,帝,媂
dai4	tɐi21	啼,鶗,鵜,鯷,騠,題,隄,醍,遆,蹄,踶{蹄},謕,褆{衣厚貌},荑{初生葉貌},緹,綈,禔,磃{磄磃},瑅,提,媞{媞媞},堤{河堤，堤壩},埞{同堤/隄字}
dai5	tɐi24	娣,弟{(白)兄弟，老弟，阿弟，弟[tɐi21]弟}
dai6	tɐi22	俤,隸{奴隸，隸書，讀同棣},遞{傳遞，遞交},逮{逮捕；逮老鼠},踶{踢},第,睇{目小視也},棣,杕,悌{孝悌，愷悌},弟{徒弟，弟子},嵽{岹嵽},娣{(又)},埭
dak2	tɐk3	嘚,鍀,惪,德,得
dak6	tɐk2	樴{(又)},螣{食禾蟲},特
dam1	tɐm53	揼{假借字，牛用角挑，渠捱牛～一角，疑本字揕},耽{(白)～頹，遲鈍、傻，由遲延義引申爲遲鈍}
dam2	tɐm33	丼{投物井中聲；姓},黕{污垢；黝黑},抌{捶，與䂿/撘對轉；搶劫，捱土匪～；編織，～布}
dam3	tɐm55	䐺{(白)肥～～，矮胖貌，矮～～，又矮又胖},髧{(語)垂下，與耷/塌對轉},揼{假借字，用勺、匙舀，～酒，斟酒，疑本字擔；～雞，一種稻田裏的鳥，形似雞，疑本字窞}
dam4	tɐm21	坍{(語)壓；塌下；周～圍，四周圍、環中心部分},𧽼{(白)～～轉，團團轉},榃{水塘；地名，榃蒙（在賓陽縣），榃冷村（在橫縣）}
dam5	tɐm24	凼{同氹字},窞{(白)小水坑，俗字氹/凼},氹{小水坑，本字窞}
dam6	tɐm22	䂿{(白)跺，～腳},𨂽{俗字，跺，本字䂿}
dan1	tɐn53	吨{同噸字},驐,鐓{同驐字；衝壓金屬板，使其變形},蹾{蹲下；猛地往下放},蹲{蹲下，蹲點},礅,敦{敦厚，敦促；〈語〉矮～～，矮而胖},撴,撉,扽{猛地拽、扯、放，～斷，與挃對轉},惇,墩{墩布，土墩；面珠～，臉蛋兒、臉頰},噸{一噸，噸位}
dan2	tɐn33	墩{(白)墩子，磚～、橋～、石～；矮～～，矮墩墩；放置（重物）},𣎴,躉{躉船，躉賣}
dan3	tɐn55	扽{顛簸；震動，～落},頓{整頓，頓號；〈語〉用力往下放},燉{燉品，燉盅，燉粉糕（本地小吃）},炖{同燉字}
dan4	tɐn21	囤{〈動〉囤積，囤貨；〈名〉米囤，糧囤},魨,迍{迍迍},豚{海豚，河豚},臀{臀部，臀圍},忳{憂也；亂也},屯{村屯，屯兵；肥～～，胖貌},坉{以草裹土築城及填水；田隴}
dan6	tɐn22	坉{同沌字；塞},鈍{遲鈍，鈍角},遯,遁,砘,盾{矛盾},盹,沌{混沌},楯{同盾字},屯{地名，屯里}
dang1	tɐŋ53	僜{同登字；僜人},鐙{通豋字，食器，瓦豆；同燈字},蹬{腳向下用力},簦,瞪{瞪眼},登{攀登，登山},璒,燈,噔
dang2	tɐŋ33	戥{小秤，釐～，戥子，本字等},等{相等，等候；用容器去接，～水，接水}
dang3	tɐŋ55	凳,鐙{鞍鐙，馬鐙},磴,嶝
dang4	tɐŋ21	同{(語)又音，疑問代詞，～能[nɐŋ24]，怎麼，能爲哪樣的合音},鰧,驣,騰,謄{謄寫},螣{螣蛇},藤,縢,籐,疼,滕
dang6	tɐŋ22	僜{倰僜},鄧,蹬{蹭蹬},瞪{(又)},澄{水渾，澄一澄},戥{相稱、替、湊，～興[heŋ55]，湊熱鬧，一說本字幐/𢯭}
dap2	tɐp3	塌{垂下，～頭，低頭，俗字耷，與髧對轉，古讀濁入，墮也},耷{俗字，垂下，～頭，低頭，本字塌，墮也，與髧對轉},撘{(白)砍、斬，～排骨}
dap3	tɐp5	嗒{(白)魚～腳，魚嘴碰人腳，俗字𠹥}
dap6	tɐp2	䂿{(白)砸、捶，～背脊，俗字撘},𢱕{俗字，砸、捶，本字䂿},撘{(語)砸、捶，～背脊，本字䂿}
dat2	tɐt3	咄{咄咄逼人，咄咄怪事},飿{餶飿},柮,挃{(白)用力往下放，知母讀如端母，與扽對轉，俗字𠱂}
dat3	tɐt5	腯{(白)肥～～，胖乎乎，矮～～，形容人又矮又小，與肭旁轉，又讀[tɐk5]},𢲼{(白)猛地用力摘取，～果，與搣旁轉（端組、泥明母旁轉）}
dat6	tɐt2	凸{凸起，凹凸},鶟,葖,腯{肥也},突{衝突，突然；象聲詞，機槍聲、發動機聲；詞綴，啲[ti21]啲[ti21]～～，說話結巴，脤～～，（蓮藕、芋頭等）不麪、不粉}
dau1	tɐu53	㨮,銩,蔸{禾蔸；量詞，棵、叢、條，本字株，上古侯部},篼,唗,兜{褲兜，兜風，兜售},丟
dau2	tɐu33	抖,陡,阧,鈄,赳{(習)赳赳，俗從斗作﨣},蚪,糾{(習)糾纏，糾正，俗從斗作紏},枓{枓栱},斗{北斗，斗篷}
dau3	tɐu55	竇{(白)窩、巢},鬭{拼合，～木，木工活，～木佬，木匠，俗字鬥},鬥{爭鬥，鬥雞；～毒，故意作對；〈語〉～木，拼合木頭，指木工活，本字鬭},逗{挑逗，又作挑鬥；引逗，～鬼崽，逗小孩}
dau4	tɐu21	投,骰{骰子},頭,酘{酒再釀},牏{(又)}
dau6	tɐu22	哣{俗字，吽～，迷糊、不清醒，本地又指古板、難溝通，疑本字䠗逗/譳䛠},餖,逗{逗號，逗遛},豆{黃豆；～泥，質量差},讀{句讀},荳,脰,竇{情竇；姓},痘
de1	te53	爹{爹孃，爹爹}
de2	te33	嗲{撒嬌；～～咧[le33]咧[le33]，撒嬌聲或態度},襶{(習)褦襶（衣着不整；吊兒郎當），或與襰𧜁同源}
de3	te55	哆{(語)嗬[ho21]～，嗩吶}
de4	te21	嗲{詞綴，啲[ti21]啲[ti21]～～，滴瀝貌；昏～～，暈頭轉向、頭暈；軟～～，軟弱無力、軟綿綿}
dem1	tɛm53	鵮{(白)叮、啄；叼、銜}
dem2	tɛm33	點{點燈，點心，小數點；蘸，～鹽，～水}
den1	tɛn53	扽{(白)對着接近，～到耳朵去𱤜（未曾）聽見}
den4	tɛn21	彈{(白)彈波珠，彈手指}
den6	tɛn22	埞{俗字，地方，本字壂},壂{(白)皇帝～，皇帝坐的凳；地方，阻/礙～，佔地方}
dep3	tɛp5	䑜{(訓)小口嚐；～嘴，親嘴，本字嗒},鰈{(語)魚～子，手上的痦子，源自魚鱗痣},蹀{(白)豬腳～，豬爪兒},嗒{(白)～口脣，咂嘴；～嘴，親嘴，俗字䑜}
det6	tɛt2	突{(白)詞綴，脤～～，（蓮藕、芋頭等）不麪、不粉}
deu3	tɛu55	屌{男陰，麻～，本字鳥},鳥{(白)男陰，麻～，俗字屌}
deu6	tɛu22	掉{(白)同調字，～動，～轉},調{(白)調轉，調動}
di1	ti53	哋{(語)矮～～，形容人矮而小}
di3	ti55	啲{俗字，一～，一點兒，一說本字稚，知組讀如端組；阿～爾[ȵi22]～，這裏那裏，哪～，哪裏}
di4	ti21	啲{(語)～～嗲[te21]嗲[te21]，滴瀝貌；～～突突，說話結巴}
di6	ti22	哋{俗字，我～，我們，本字等（上古蒸部），與臺（上古之部）字對轉，輩也},緻{(白)緊密、無縫隙，亞塊門板冇夠～；案，知組三等讀如端組},墬,地{土地，鋤大地；助詞}
diak2	tiɐk3	剁{(訓)～肉，訓讀斲},斲{剁，～肉}
diang3	tiɐŋ55	掟{(語)擲、扔，本字矴，與扚對轉},碇{(白)蒂，俗字椗；擲、扔，俗字掟，與扚對轉},矴{(白)蒂，俗字椗；擲、扔，俗字掟，與扚對轉},椗{(白)蒂，本字矴}
diang5	tiɐŋ24	艇{(又)}
dik2	tek3	嫡{嫡系，嫡親},鏑{箭鏃；金屬元素，符號Dy},迪{(白)跑、出奔，俗字趯},蹢{蹄},趯{(訓)跑、出奔，本字迪},菂,的{目的，的確},玓,滴{滴水，水滴；～息，小巧，與丁對轉},樀,扚,底{同的字}
dik3	tek5	嘀{嘀嗒},的{(語)～士，出租車；柔姿～，三輪車；硬～～，硬邦邦；～軲[ku33]轤[lu33]，一種遊戲，在斜板上擊銅元向前滾，以遠近決勝負}
dik6	tek2	䯼,頔,逖{(又)},迪{啓迪，愛迪生},踧{踧踧},覿,荻,翟{長尾野雞},糴,篴,笛{吹笛，汽笛},狄,滌,浟{貪利貌},敵,嘀{嘀咕}
dim1	tim53	掂{掂量，本字敁，與拈旁轉},踮,敁{敁敠}
dim2	tim33	㥏,點{(又)點數},靦{靦顏},覥,腆{(習)靦腆，腆肚},碘{(習)碘酒},淟,晪,捵{推、頂},典{(習)經典，典型}
dim3	tim55	坫,阽,玷,惦,店
dim4	tim21	恬,菾,甜,湉
dim6	tim22	墊{(訓)坐墊，墊錢，訓讀簟},簟{蓆},磹{石楔；同簟字},掂{妥當，搞～，弄妥當；案，元代作扎掂/扎墊，墊訓讀簟，故本字簟},扂
din1	tin53	巔,顛,癲,滇{滇池；雲南},槙{樹梢},攧
din2	tin33	典{(書)},碘{(書)}
din4	tin21	佃{佃作},鿬,闐,鈿{錢},窴,畠{日本漢字，讀同田},畑{日本漢字，讀同田},畋,田{單用專指水田；種田，田園},滇{水流貌},沺,填,嗔{嗔嗔}
din5	tin24	殄
din6	tin22	佃{佃戶},靛,電,鈿{金花形飾物},癜,甸,琔,澱{澱粉，沉澱},淀{白洋淀},殿,奠,壂{地基}
ding1	teŋ53	丁{丙丁，壯丁，肉丁；單～，孤單、單獨，與滴對轉},靪,釘{鐵釘},酊{碘酊},訂{(訓)訂書機，裝訂，訓讀釘},虰{虰蛵},耵,盯{盯住，盯梢},疔{疔瘡，疔毒},町{地名，畹町（在雲南），西門町（在臺灣）},玎,叮{叮嚀；叮咬},仃{伶仃}
ding2	teŋ33	酊{酩酊},鼎,頂{屋頂，頂住}
ding3	teŋ55	椗{(文)同矴字},飣,釘{釘住},訂{訂檯，訂婚，修訂},碇{同矴字，錘舟石},矴{錘舟石，又作碇字}
ding4	teŋ21	䗴,霆,蜓{蜻蜓},葶,莛,綎{(又)},渟,廷,庭,婷,停{停止，停留},亭{涼亭，亭子}
ding5	teŋ24	梃,鋌{鋌而走險},艇{遊艇，快艇},烶
ding6	teŋ22	啶,錠{銀錠},鋌{銅鐵礦石；同錠字},萣,腚,掟{天掟},定{安定，定時；落～、落～錢，付定金、放定}
dip2	tip3	跕{墜落}
dip6	tip2	喋{喋喋不休，喋血},鰈{鰈魚},迭{(又)俗讀},蹀{躞蹀，蹀足},諜,蝶,秩{(又)俗讀},碟,疊,牒,渫{渫渫},楪{同牒/碟字},揲{摺揲},堞
dit2	tit3	跌{跌跤，跌打；丟失，我～了一支水筆}
dit3	tit5	啲{(又)表少量，或爲連讀音變，另一說本字尐}
dit6	tit2	䏲,𢲼{擿也},迭{更迭，迭代},跮{跮跮},詄,螲{螲蟷},耋,絰,紩,秩{秩序，厚秩},瓞,昳{太陽偏西},帙,嵽{嵽嵲},垤,咥{咬}
diu1	tiu53	䯾{小兒留髮},鵰{射鵰，一箭雙鵰},鯛,雕{射雕；雕像，雕刻},錭,貂,碉,琱{琱琢},汈,椆{椆苕},彫{彫刻；彫弓},叼,刁,凋{凋零，凋謝}
diu2	tiu33	屌{性交，本字鳥，～㞓，交合，～咳，臭罵、訓斥，狗～出，狗雜種},鳥{(白)性交，俗字屌}
diu3	tiu55	吊{懸吊，吊起},銱,釣,窵,弔{弔唁，憑弔}
diu4	tiu21	䯾{髮多},齠,鰷,髫,銚{長矛},迢,調{調和，調整},蜩,苕{凌霄花；苕菜},笤,條{條件，字條；量詞，一條魚，一條橋（一座橋），一條村（一座村）},岧,嬥{身材修長而美好},佻{佻佻}
diu5	tiu24	窕
diu6	tiu22	嬥{嬥嬈},銚{燒器},調{音調，調動},藋{灰藋菜},蓧,莜{草田器},掉{改掉，走掉}
do1	to53	哆{哆嗦},多
do2	to33	嚲,躲
do3	to55	陀{(白)圝～螺[lo55]，形容很圓}
do4	to21	佗,鼧,鼉,鴕,鮀,駝{駝背，駱駝},馱{馱起},陁{盤陁，同盤陀},陀{陀螺，肉陀},阤{陂阤},鉈{秤砣},酡,跎{蹉跎},砣,沱,柁{木葉落；房柁},堶,坨
do6	to22	垛{柴垛},馱{馱子；地名，馱盧},陊,舵{(又)},惰,墮
doek2	tœk3	㞘{同䐁字},篤{篤厚，篤信},督{督促，監督},毒{(古)身毒，印度的古譯名},䐁{容器或物體底部，腳～，腳跟，又作㞘字；量詞，泡（用於屎尿），另一說本字涿；地名，葫蘆～，即葫蘆頂，因白沙半島盡頭頂部似葫蘆底部得名，上建大橋稱葫蘆頂大橋，後被愚蠢的官員自以爲是改名爲葫蘆鼎，破壞了原本語義清晰的歷史地名}
doek3	tœk5	厾{輕點；同𧰵字},𧰵{戳、刺、捅，與捅對轉},突{(語)～頭，奔兒頭、凸額，或爲凸額/殼的合音，又或本字𧰵；珠[ty53]～，疙瘩}
doek6	tœk2	櫝,黷,髑,頓{古人名，冒頓},讟,讀{讀書},纛{(又)},碡{磟碡，又作碌碡},獨,犢{牛犢},牘,瀆,毒{毒蛇，病毒；鬥～，故意作對}
doeng1	tœŋ53	冬,鼕{鼓聲},鶇,鮗,蝀,菄,氡,棟{(又)量詞，專用於祠堂，一～祠堂，大～祠堂},柊{(又)},東,崬,咚{象聲詞}
doeng2	tœŋ33	懂,董
doeng3	tœŋ55	凍{冷凍},腖,棟{棟樑；一棟},彤{(又)紅彤彤}
doeng4	tœŋ21	仝{姓},𦒍,鼕{(又)},鮦{鮦魚},銅,酮,詷{共同},衕{衚衕},茼{茼蒿},艟{艨艟，讀同童},筒{竹筒，筒骨（豬的腿骨和脛骨）；量詞},童,穜{先種後熟的農作物},砼,瞳,犝{牛犝，未受過訓的小牛},烔,潼,洞{澒洞；洪洞縣},橦{木棉樹},桐,朣,曈,彤{彤雲，紅彤彤},峒{崆峒},峂,垌{地名，坰冢（在湖北）},哃,同{共同，同時；疑問代詞，～能[nɐŋ24]，怎麼，能爲哪樣的合音},僮{書僮},侗{倥侗},佟
doeng6	tœŋ22	侗{侗族},詷{說謊},胴,硐,洞{山洞，洞察},戙{船板木；〈語〉豎起，～腳，坐凳時一隻腳踏在凳上},慟,恫{恫嚇},峒{山洞},垌{田垌；量詞，片，用於農田，～田，成片的田；地名，平垌村，潭垌},動
dot3	tot5	凸{(語)～嘴，嘬嘴；～芽，發芽},𡁯{俗字，～～車，童語，汽車},腯{(白)矮～～，形容人矮而小，與肭旁轉}
du1	tu53	嘟{咕嘟，嘟囔；花咕[ku33]～，花蕾、花骨朵},闍{城門臺},都{都城；都是；姓}
du2	tu33	哚{吲哚},鬌{小兒翦髮；髪美},跺,賭,肚{(又)豬肚},綞{綞子},睹,朵{花朵，耳朵；量詞，一朵},奲{同嚲字},堵,埵
du3	tu55	剁{剁肉，剁碎},嘟{象聲詞，～嚕[lu55]咑[ta55]喇[la55]，東西掉落聲}
du4	tu21	圖,駼,酴,途,菟{於菟},荼{荼毒，如火如荼},稌,瘏,涂{姓；通塗/途字},梌,徒,屠,塗{泥塗，塗抹}
du5	tu24	肚{豬肚；肚皮}
du6	tu22	妒{妒忌，嫉妒},𨧀,鍍,蠹,芏,艔{粵字，渡船，本字渡},渡{擺渡，渡船},杜,度{長度，度量},妬{同妒字}
dui1	tui53	䭔{油～，麻團，俗字堆},堆,埻{欑塗所覆}
dui2	tui33	㨃{捅}
dui3	tui55	對{對錯，比對；～拳、拳～、～得住，猜碼口令，數字零},祋,碓,敦{盛黍稷之器}
dui4	tui21	尵,魋{獸名},頽,頹{頹廢，傾頹；〈語〉蠢笨，耽[tɐm53]～，遲鈍、傻},隤,穨
dui6	tui22	兌,隊,鐓{同錞字},錞{鐏},懟{怨也},憝
duk2	tok3	啄{啄木鳥，啄食}
duk3	tok5	突{(語)又音，珠[ty53]～，疙瘩}
dun1	tun53	端,耑{端的古字；姓}
dun2	tun33	短
dun3	tun55	斷{判斷，決斷},鍛{鍛鍊，鍛造},碫,瑖,煅
dun4	tun21	團{團結},糰{糯米糰},槫,摶
dun5	tun24	斷{折斷，斷絕},籪
dun6	tun22	塅,緞{綢緞，緞面},毈,段,椴
dung2	toŋ33	捅{(語)用棍子捅、戳，～亞隻木瓜落來；～訂帽，一種鳥，頭上有一撮長毛，像戴了一頂帽子，故名}
dut2	tut3	掇{(又)},敠{敁敠；估量，～堆，按堆估重，～水，估計家禽家畜的毛重}
dut3	tut5	腯{(白)肥～～，胖乎乎}
dut6	tut2	奪,敓
dyu1	ty53	噘{(訓)～嘴，努嘴，本字豬，知組三等讀如端組},豬{(白)～嘴，努嘴，知組三等讀如端組},珠{(白)皮膚上的小疙瘩，蚊子～，被蚊子叮後腫起的小包；姣～，戲稱粉刺；～突[tœk5/tok5]，疙瘩；案，章組讀如端組}
dyu3	ty55	蛀{(白)（蚊蟲）叮，（馬蜂）蟄；案，章組讀如端組}
dyu5	ty24	遞{(語)遞，疑本字柱，支也，知組三等讀如端組}
e3	∅e55	嘅{(語)弱讀},隘{(白)腋[ak3]～，胳肢窩}
e6	∅e22	欸{嘆詞},誒{嘆詞}
em1	∅ɛm53	菴{(白)～根，蕨菜、芭茅}
em3	∅ɛm55	窨{(白)～子，扒手}
en2	∅ɛn33	偃{(白)踮，～腳},躽{(白)挺，～肚，腆肚}
et2	∅ɛt3	䊦{(白)（用芭蕉葉等包裹的）餈粑},噎{(白)}
et3	∅ɛt5	撅{(訓)翹，凳～起來喇}
eu1	∅ɛu53	吆{(白)叫，喊}
eu2	∅ɛu33	拗{(白)～斷，折斷}
eu3	∅ɛu55	拗{(白)～喉～頸，擡槓、頂嘴，又作詏字},詏{(白)同拗字，～喉～頸，擡槓、頂嘴}
faak2	fak3	礊{(又)抽打；攪動，～勻；～回頭，掉轉頭}
faak3	fak5	礊{抽打，～牛，鞭打牛}
faam5	fam24	犯{(白)妨礙，中邪（迷信說法）}
faam6	fam22	犯{犯人，犯法}
faan1	fan53	噃{聲也},藩{(又)藩籬},蕃{通番字，外國、外族},翻{翻譯，推翻，翻新},繙{繙譯},番{幾番；番茄},旛,幡{經幡，幡然醒悟}
faan2	fan33	反{反覆；平反，古讀平聲},返{返回，往返},橎
faan3	fan55	嬎{鳥下蛋},販,范{姓},範{示範，模範},畈,泛{廣泛，泛舟},汎,氾{氾濫},嬔{同嬎字}
faan4	fan21	凡,鷭,鐇,釩,蹯,袢{近身衣},蘩,藩{藩籬；藩衍},蕃{蕃息，蕃茂},繙{繙㠾},繁{繁華},礬,璠,燔,煩,氾{姓},樊,帆{帆船，帆布，風帆},墦
faan6	fan22	梵,飯,番{番桃},犯{(又)}
faat2	fat3	法{方法，法律},髮{頭髮},醱{醱酵，同發酵},砝{砝碼},發{發財},琺
faat6	fat2	㩢{(白)～𪒜[mat5]，誣賴、抹黑},𠲎,閥,罰,筏,抹{(白)～𪒜[mat5]，誣賴、抹黑，本字㩢},垡,伐,乏
fai3	fɐi55	䛍{言急；〈語〉癡～，瘋癲貌，俗字廢},芾{蔽芾},沸{沸騰，沸水}
fak2	fɐk3	礊{(又)甩}
fak3	fɐk5	礊{甩，與揈對轉}
fam4	fɐm21	弇{(訓)伏、趴，疑本字𨂝}
fan1	fɐn53	㬟{同朆字},雰,錀{兔奄錀},酚,芬,翂,紛,玢{賽璐玢},氛,棼{棼棼},棻,朆{吳語字，弗曾},吩,分{分開}
fan2	fɐn33	粉
fan3	fɐn55	瀵,糞
fan4	fɐn21	墳,鼢,馼{(老派)},雯{(老派)},闅{(老派)},閿{(老派)},賁{大；三足龜},豶{牡豕},芠{(老派)},聞{(老派)},紋{(老派)},玟{(老派)},焚,濆{水邊},汾,棼{紛亂},旻{(老派)},文{文章，論文；文過飾非，古讀去聲},忞{(老派)}
fan5	fɐn24	僨,鱝,憤,忿{忿恨，忿忿不平},奮{奮鬥，興奮},坋{塵也；地名用字}
fan6	fɐn22	份{兩份，月份},聞{(老派)},分{本分}
fang2	fɐŋ33	晃{(又)}
fang3	fɐŋ55	揈{俗字，甩，疑本字迸/砰，與礊對轉；～哩[li55]哩[li55]，得意貌}
fang4	fɐŋ21	揈{(又)～寥[liu55]寥[liu55]，得意貌}
fat2	fɐt3	㧾{擊也},黻,鮄,韍,鍃,茀,芾{草木茂盛},艴{淺色；艴然；〈語〉紅～～，（面色）紅潤},紼,紱,笏,祓,淴,沸{灑；泉涌貌},氟,欻{忽然},曶,昒,拂{拂曉，拂塵；甩；摔，～跤，摔跤},惚,忽{忽然，忽略，疏忽},弗{弗如，弗要},巿,囫,唿{唿哨},䬍{疾風貌},㺀
fat5	fɐt24	勿{(老派)},芴{(老派)},物{(老派)},沕{(老派)}
fat6	fɐt2	佛{佛教；仿佛，讀同佛祖之佛},髴{髣髴},砩{砩石},狒{(語)狒狒，讀同佛},拂{(又)讀同佛},怫{怫鬱，怫然},彿{彷彿，讀同佛},弗{(又)讀同佛},咈{違逆；乖戾}
fau2	fɐu33	不{同否字},缶,稃{(白)虛僞，亞隻人～一世，又作秠字},殕{物敗也},否{否定}
fau4	fɐu21	浮{浮動，輕浮},衃{蚍衃},蜉,芣,罦,罘,琈,涪
fau6	fɐu22	埠{阜的分化字，商埠，開埠，大埠，蚌埠市；〈又〉埠頭，船埠},阜
fet3	fɛt5	唿{(白)～～，哨子或哨聲},艴{(白)揈[fɐŋ21]～～，心裏高興或輕輕浮浮},法{(白)符～，符籙，引申爲戲法、把戲}
fi1	fi53	啡{咖啡，嗎啡},鯡,騑,飛{飛機；～髮，理髮；票，買～，買票；阿～，青年流氓，後起詞},非,霏,蜚{蜚語},菲{芳菲},緋{緋紅，緋聞},扉,妃
fi2	fi33	匪{匪徒，土匪},誹,蜚{蜚廉},菲{菲薄},篚,榧{香榧},棐,朏{朏明，朏魄},斐,悱
fi3	fi55	㹃{覆耕},鐨,費{費用},肺,翡{翡翠},砩{以石攔水},痱{痱子，熱痱},疿{痱子},廢{廢品，作廢},啡{(語)～～䬍[fot2]䬍[fot2]/吙[fo22]吙[fo22]，風風火火},䉬
fi4	fi21	淝,蜰,腓,肥,痱{中風病}
fi6	fi22	剕,狒{獸名},吠
fik3	fek5	揊{(白)甩，與摒對轉，俗字𠱥},𠱥{俗字，甩，本字揊，與捹/摒對轉}
fing3	feŋ55	捹{粵字，甩，本字摒，除也，與𠱥/揊對轉},摒{(白)甩，與揊對轉，俗字捹}
fit3	fit5	撇{(白)抽打，～一鞭},艴{(白)紅～～，（面色）紅潤，又讀[fek5]}
fiu3	fiu55	覅{吳語字，弗要}
fo4	fo21	吙{(語)～～聲，熟睡聲、火旺貌、風嘯聲}
fo6	fo22	吙{(語)啡[fi55]啡[fi55]～～，風風火火，䬍的連讀音變}
foek2	fœk3	复{行故道；同復/複字},鰒,馥,輻,覆{覆蓋，傾覆},複{複雜，重複},蝮,蝠{蝙蝠（口語稱飛鼠）},腹,福,復{(習)復原；復興，古讀去聲，扶富切},幅{幅度，條幅；量詞，一幅被（一張被子），一幅牆（一堵牆）}
foek6	fœk2	伏{埋伏，伏案},襆,袱,菔,茯,洑,栿{房樑},服,復{(書)復原},幞{幞頭},宓{姓},匐{匍匐}
foeng1	fœŋ53	丰{丰姿，丰采},飌,風,鋒,酆,豐{豐收，豐富},蜂,葑{蕪菁},碸,瘋,烽,灃,楓,崶,峰{同峯字},峯{山峯，峯巒},封
foeng2	fœŋ33	唪{唪經}
foeng3	fœŋ55	葑{菰根},賵,諷{諷刺，譏諷}
foeng4	fœŋ21	浲,馮{姓},逢{相逢，逢迎},縫{(動)縫補},渢{水聲；宏大聲}
foeng6	fœŋ22	俸{俸祿，薪俸},鳳,縫{(名)裂縫，俗讀縫補之縫},甮,奉
fot6	fot2	䬍{(語)啡[fi55]啡[fi55]～～，風風火火，又連讀音變作吙[fɔ22]}
fu1	fu53	伕{車伕，馬伕，伙伕},麩{麩皮},鈇,鄜,郛,跗{跗面},趺,莩{葭莩},膚,罦{(又)},稃{穀皮},砆,玞,桴,枹{鼓槌},敷,孵{孵化},孚,夫{夫妻，功夫},垺{同郛字},呋,俘{俘虜}
fu2	fu33	㕮,黼{(又)},鬴,頫,釜,輔{(又)},莆{萐莆},腑{臟腑，肺腑},簠,父{尼父，田父},滏,殕{(又)},斧,撫,拊,府,婦{(白)新～，兒媳婦},嘸{驚愕},俯,俛{同俯字}
fu3	fu55	仆{頓也},赴{奔赴，赴會，前赴後繼},賦,訃{訃告，訃聞},富,嬔{同嬎字},嬎{兔崽},咐{吩咐，囑咐},副,付{交付，付款}
fu4	fu21	夫{悲夫},鵐{(老派)},鳧,蚨,蕪{(老派)},苻,芙{芙蓉},腑{(語)腑胵[tʃʰi55]，家禽內臟，炒～胵、～胵湯，俗作扶翅/芙翅},符,無{(老派)},毋{(老派)},榑,扶
fu5	fu24	㵲{(老派)},鵡{(老派)},舞{(老派)},碔{(老派)},珷{(老派)},潕{(老派)},武{(老派)},憮{(老派)},廡{(老派)},嫵{(老派)},侮{(老派)}
fu6	fu22	㳇,鶩{(老派)},鮒,騖{(老派)},駙,霧{(老派)},附,賻,負{負擔，勝負，負氣},蝜,腐{豆腐，腐敗},秿{禾捆},祔,父{父母，祖父，舅父，伯父},婺{(老派)},婦{婦女，夫婦，媳婦，市婦幼（本地醫院）},務{(老派)},傅{師傅；姓}
fuk6	fok2	縛{束縛，自縛}
fung1	foŋ53	坊{街坊，牌坊；地名，三坊街（龍勝街、尚仁里、南倫街的合稱）},鈁,邡,蚄,芳,肪{脂肪},牥,枋,方
fung2	foŋ33	仿{相仿，仿效（倣傚），仿佛（髣髴）},髣{髣髴},訪,舫,紡,昉,彷{彷彿},倣{倣傚}
fung3	foŋ55	放
fung4	foŋ21	坊{作坊，油坊，酒坊；同防字},鰟{同魴字},魴,防,肪{(又)},房{房間},妨{妨害}
ga2	kɐ33	嘅{(語)弱讀}
gaa1	ka53	㹢,鎵,迦,跏,豭,袈,葭,茄{荷莖；雪茄},笳,癿{(又)},痂,珈,泇,歌{(白)唱歌堂},枷,尕,家{家庭，商家},噶{譯音用字，噶倫},嘎{象聲詞，裂聲、笑聲，～吱聲、～～笑},嘉,加{加法，更加},傢{傢俱，傢伙},伽{伽利略}
gaa2	ka33	假{真假；～相，做作、假正經},賈{姓},瘕{腹內結塊},玍{調皮、乖僻},檟,斝,嘏{(又)},嘎{同玍字，調皮、乖僻，～子},叚{借也，後作假}
gaa3	ka55	㗎{粵字，語氣詞，嘅啊的合音，本地不合音，常弱讀爲嘅[e33]啊[a22]，渠好高～},稼,旮{～旯頭，苤藍或苤藍的莖},嫁,咖{咖喱},價,价{同價字}
gaa4	ka21	咔{(語)阻塞，～頸，卡頸，與卡同源},尜{尜尜兒},嘎{嘎調，嘎嘎兒（尜尜兒）；音譯用字，～佬，民族語稱大哥}
gaai1	kai53	佳,隑{梯子},階,陔,鍇{(又)},賅,該,街,薢,荄,胲{牲蹄},稭{麥稭},秸{麥秸，秸稈},皆,痎,湝,楷{楷樹；楷書},晐,垓,嚌{嚌嚌},喈,偕{偕老，偕同}
gaai2	kai33	改,解{解開},胲{臉頰},檞
gaai3	kai55	丐{乞丐，丐幫},齘,骱{骨節間銜接處},誡,解{押解；鋸斷，～木板，俗字刉/刏/鎅/𠝹},蚧,蓋{瓶蓋；蓋被},芥,疥,界,玠,犗,械{機械，讀同戒},戒,悈,廨{(又)},岕,屆,尬{尷尬},刏{(訓)鋸斷，本字解},刉{(訓)鋸斷，本字解},价{善也；僕役；介紹},介
gaak2	kak3	傕,閣{樓閣，閣下},鉻{金屬元素，符號Gr},角{牛角，角色},袼{袼褙},硌{硌腳，硌牙},珏,玨,桷{榱桷，椽桷；～子，椽子},斠{平斗斛},擱{(文)},咯{雞叫聲；咯噔，咯咯笑},各
gaak6	kak2	硌{(語)歏[kan22]～，不順心、不滿足}
gaam1	kam53	尷{(又)},苷,緘{緘口，緘默；古人名，蘇緘},監{監視，坐監},疳{疳積，牙疳，下疳},甘,泔{泔水},柑{柑橘，柑果}
gaam2	kam33	噉{粵字，表狀態，這樣/那樣，箇物（箇麼）的合音，本地用梗/耿[kiɐŋ55]},鱤,澉,減{減少，加減},橄{橄欖},敢,感
gaam3	kam55	㽏,鑒{鑒定},鑑{銅鑑，印鑑},贛{贛江},紺,監{太監，國子監},淦,尷{尷尬，後字調類化},咁{粵字，表程度，這麼/那麼，箇物（箇麼）的合音，本地用梗/耿[kiɐŋ55]}
gaan1	kan53	乾{乾燥，乾淨},間{中間，時間},酐{酸酐},虷{侵犯},菅,艱{艱難，艱苦},肝{肝膽，豬肝（口語稱豬溼）},竿{竹竿},矸{矸石，丹矸},玕,漧,杆{旗杆，欄杆；量詞，用於高爾夫，一杆進洞},干{天干，干涉，干脆},姦{強姦，姦淫},奸{奸詐，內奸}
gaan2	kan33	堿{(文)},鹼{(文)},鹻{(文)},鐧{殺手鐧},趼{(文)},趕,赶,襉,茧{(文)},繭{(文)},簡{簡單，竹簡},筧{引水的長竹管},笴,稈{稻稈，禾稈},碱{(文)},梘{(文)},桿{筆桿，桿秤；量詞，一桿槍},柬,杆{筆杆，杆秤；量詞，一杆槍},暕{陰雨後晴},擀{擀麪},揀{(文)},扞{同擀字}
gaan3	kan55	幹{骨幹，幹勁，幹部},間{間隔，離間},鐧{車鐧},諫,簳,矸{山石貌},瞷,澗,榦{同幹字},旰{宵衣旰食}
gaan6	kan22	歏{(語)～硌[kak2]，不順心、不滿足}
gaang1	kaŋ53	亢{人頸},阬{大山坡},鋼{鋼鐵，鋼筆，不鏽鋼},釭,豇{豇豆},茳,舡{(又)},肛,罡,缸,綱,笐{竹列},矼,瓨,玒{(又)},江,棡,杠{牀前橫木},摃,掆{擡、扛},扛{力能扛鼎},崗,岡,堽{地名，長堽嶺},剛,冮
gaang2	kaŋ33	港{港口},講,耩{耩地}
gaang3	kaŋ55	杠{同槓字，杠桿，單杠},鿍,降{下降},鋼{鋼一鋼},虹{(白)},絳,洚,槓{槓桿，單槓}
gaang6	kaŋ22	俇{(語)打露～，裸下身}
gaap2	kap3	㪉,鴿{白鴿，鴿子},餄{餄餅},頰,頜{口；姓},閤{小門；姓},鋏,鉿{陷聲},鉀,郟,跲,裌{同袷字，裌衣，裌裙},袷{袷衣},蛺,蛤{蛤蜊，蛤蚧，蛤崽（小青蛙）},蓋{姓},莢{豆莢},舺,胛{肩胛，胛骨；前/後～，豬羊牛的前/後腿；上/下～，熟食鴨鵝的上/下半部（即上/下莊）},甲{甲子，盔甲，指甲},浹{(又)汗流浹背},梜,柙{木名},敆,搿,挾{(文)},岬,夾{(文)夾層，夾竹桃；夾衣，同裌衣/袷衣},合{容量單位，十合爲一升},佮{合夥，～錢，湊錢，又作敆/㪉字},䀫{眼細暗；目睫動}
gaap6	kap2	𠶲{啃、咬，引申指吃}
gaat2	kat3	割{分割，割禾},釓{金屬元素},轕,葛,擖{刮聲；斬斷},戛{戟也；戛然，戛戛},恝,噶{象聲詞},嘎{象聲詞，鴨聲、雁聲}
gaat6	kat2	曱{俗字，～甴，蟑螂，本字甲蚻，前字受後字逆同化}
gaau1	kau53	交{交錢，成交，交叉；爭～，吵架},鵁,鮫{鮫魚，鮫人，馬鮫},高{高低},郊{郊外，城郊},轇,跤{跌跤},蛟{蛟龍},茭{茭白，茭筍},艽{秦艽},膠{膠水，橡膠},膏{(名)牙膏},羔,糕,篙{竹篙},睾{睾丸，附睾},睪{同睾字},皋,櫜,槔,教{令、使、讓},峧,嘐{雞鳴}
gaau2	kau33	佼,餃{餃子，水餃，粉餃},鎬{鎬頭},藁,縞,絞{絞肉，絞刑},筶{義未詳},筊{竹索也},稿,皎,狡{狡猾，狡詐},槁,杲,攪{打攪，攪動，攪拌},搞{亂搞，搞笑，本字攪},恔{狡黠},姣{姣好}
gaau3	kau55	告{告狀，報告；忠告，古讀入聲，古沃切},鋯,鉸{鉸刀；～剪，剪刀},郜,較{較勁，比較；〈語〉～腳，逃走、溜走},誥,覺{睡覺},膏{(動)膏車，俗讀牙膏之膏},筶{卜具},筊{同珓字},窖,窌{地窖},珓,漖{水名；地名用字},滘{河道相通處，本字漖；地名用字},校{學校，校對，上校；～鐘，對錶；地名，校椅鎮（在橫縣）},斠{斠訂，斠補},教{教書；教訓；佛教}
gaau4	kau21	攪{(語)攪拌，～勻啲},覺{(語)睡～覺[kau24]，對小孩兒稱睡覺}
gaau5	kau24	覺{(語)睡覺[kau21]～，對小孩兒稱睡覺}
gaau6	kau22	攪{(語)摎[lau24]～，胡搞、搗蛋，當是亂攪鬧之音變}
gai1	kɐi53	㚻,鷄{同雞字},雞{雞蛋，土雞；〈語〉揞～兒[ȵi21]盲、捉～兒[ȵi21]盲，捉迷藏、躲貓貓},肌{(語)囊[nɐŋ55]～，瘡疤，俗作𤹍雞},笄,機{(語)打火～；焫～，烙鐵；勾～，扳機；銀～，哨子},枅
gai3	kɐi55	瀱,髻,薊,罽
gai5	kɐi24	徛{(白)挨、靠、倚}
gai6	kɐi22	偈{佛偈；〈語〉傾～，聊天，本字傾蓋},忌{(語)怕}
gak6	kɐk2	硌{(語)卡、阻擋，～住，卡着，與梗對轉，或源自隔，塞也}
gam1	kɐm53	今,金
gam2	kɐm33	錦{(文)}
gam3	kɐm55	僸,禁{禁止；禁不起，情不自禁},噤
gam4	kɐm21	噙,黚{(又)},蠄{蟲名},芩{黃芩},禽,琴,涔{(又)},檎,梣{(又)},擒,扲{同擒字},岑{(又)地名，岑溪，讀同芩}
gam5	kɐm24	妗{～孃，舅母，～婆，舅奶奶，本爲舅母受後字逆同化而來}
gam6	kɐm22	撳{按，本字𠢱},𠢱{按，俗字撳}
gan1	kɐn53	哏{逗哏，捧哏},釿,跟,觔,筋,根,斤,巾
gan2	kɐn33	僅,饉,謹,菫,緊,瑾,殣,槿,廑{小屋；覆蓋；同僅字},巹,墐{(又)},堇
gan3	kɐn55	艮,靳,茛
gan4	kɐn21	勤,芹,矜{(古)矛柄也},懃,慬,廑{通勤字}
gan5	kɐn24	䐃{(白)禽類的胃（百姓以爲禽的腎），俗字肫},近{(白)附近，走近，近來},肫{(訓)禽類的胃（百姓以爲禽的腎），本字䐃}
gan6	kɐn22	墐,近{(文)近視},覲,歏
gang1	kɐŋ53	更{更換},緪{繩索；繃緊},浭{水名}
gang2	kɐŋ33	亙,𬒔{地名，石𬒔（在廣東）},鯁{骨鯁在喉},骾{骨骾},耿{耿直，耿耿；〈語〉古～，古板},綆,梗{桔梗，梗阻},埂{田埂},哽{哽咽}
gang3	kɐŋ55	暅{曝曬},更{更加}
gang4	kɐŋ21	緪{(語)假借字，高～～，高貌}
gang5	kɐŋ24	哽{(白)～頸，（飯、菜）卡頸},鯁{(白)～頸，（魚骨、魚刺）卡頸},骾{(白)～頸，（骨頭）卡頸},啃{(又)}
gap2	kɐp3	忣,芨{蒴藋},急
gap3	kɐp5	佮{(語)閉（口）}
gap6	kɐp2	㧀,𥄫{俗字，盯住，本字䀫},芨{白芨},岌{岌岌可危},及,䀫{(白)盯住，俗字𥄫}
gat2	kɐt3	㓤{俗字，刺、扎，本字拮/戛，戟也},郅{郅偈},詰{詰屈，即佶屈},訖{收訖},虼{虼蚤，虼螂},紇{紇繨},橘{(習)橘子；小金橘或小番茄（本地用法）則俗作桔},桔{桔梗；同橘字，多指小金橘，皮薄、黃色、味酸，本地也指小番茄；案，金錢～，本地指小番茄，與柑橘（柑果）、金橘（金柑）三者不同},拮{刺、扎，～針，源自戛，戟也，俗字㓤},姞,咭{笑貌},吉,吃{口吃},佶{健壯；佶屈聱牙}
gat6	kɐt2	䞘{行貌；〈語〉～路，滾蛋},趷{同䞘字},趌{直行},竭{(白)（粥）稠，古字渴，俗字傑},疙{疙瘩；～𤶸（𤶠），活結，引申爲吝嗇},渴{(白)（粥）稠，後作竭，俗字傑},揭{(白)擡、扛，翹起},屹{屹㟷，同圪墶},圪{圪墶}
gau1	kɐu53	佝{佝僂},龜{古國名，龜茲},鳩{斑鳩；男陰；～屎，擺架子、待理不理},鬮{拈鬮},韝,鉤{(文)},鈎{(文)},軥{(文)},緱,篝,溝,泃{水聲},摎{摎蓼},句{(文)},勾{(文)},勼{聚也}
gau2	kɐu33	久,韭,赳{(書)},苟,芶{姓},耇{高壽},糾{(書)},笱,玖,狗,灸{鍼灸},氿{湖名},枸,岣,九{九洲，九月；～長久、～～長（九諧音久）、～快，猜碼口令，數字九}
gau3	kɐu55	咎,雊,遘,購{購買，採購},詬,覯,究{研究，究竟},疚,構{結構，構造},构,救,搆,彀{彀中，彀弓},廏{馬廏},廄{同廏字},媾,姤,夠,垢
gau4	kɐu21	㞗,鼽,銶,釚,釓{同釚字},逑,賕,訄,裘,虯,莍,艽{遠荒},璆,球,犰,求,毬,巰,俅,仇{姓，俗讀仇敵之仇}
gau5	kɐu24	䊆{舂糗也；狗～，一種菜餚，將狗血灌入狗腸煮熟而成},舅,臼{石臼，脫臼},桕{烏桕樹}
gau6	kɐu22	䊆{(量)塊、團，俗字嚿},舊,柩{靈柩},嚿{(量)俗字，塊、團，本字䊆}
ge1	ke53	雞{(語)躲～，捉迷藏、躲貓貓},鷄{(語)躲～，捉迷藏、躲貓貓}
ge3	ke55	刉{(訓)又音},解{(白)割、劃，～一刀五花肉許（與）我},嘅{助詞，的，本字個},刏{(訓)又音}
ge4	ke21	伽{伽藍},茄{番茄；〈語〉黃～～，發黃，貶義},癿
ge5	ke24	耆{(語)老～，年紀大而個子小、長不高，成年歲數以上皆可用}
ge6	ke22	旮{(語)門～，門縫；～旮[le21]子，縫}
gem4	kɛm21	箝{(白)},黔{(白)燒、燎},鉗{(白)老虎鉗，蟛鉗（小河蟹）}
gem5	kɛm24	䭑{(語)舔},魽{(白)俗字，魽魚，學名斑點叉尾鮰，又叫鉗魚/溝鮎，英語ChannelCatfish，魽爲音譯},芡{(白)打～，勾芡},舔{(語)舔，～碗，又作䭑字}
gen2	kɛn33	堿{(白)同碱字},鹼{(白)鹼性，燒鹼；肥皂，俗字梘},鹻{(白)同鹼字},趼{(白)足趼，老趼},茧{(白)同繭字},繭{(白)蠶繭；通趼字，起繭},碱{(白)鹼的俗字},梘{(白)通水器；肥皂，本字鹼},揀{(白)揀選}
gen5	kɛn24	𠐻{(白)驕傲；自以爲是}
gep2	kɛp3	夾{(白)鐵夾；夾住；夾衣，同裌衣/袷衣},裌{(白)裌衣，裌裙},袷{(白)袷衣},篋{(語)皮～，皮革手提箱，本字笈},笈{(白)皮～，皮革手提箱},挾{(白)挾菜}
gep3	kɛp5	喼{～紙，紙炮，因形似火帽得名，英語cap；～釦，按釦}
get2	kɛt3	割{(白)老派},葛{(白)老派}
geu1	kɛu53	膠{(白)膠水，膠擦（橡皮），膠箍（橡皮筋）}
geu2	kɛu33	攪{(白)攪動，攪拌},絞{(白)絞線，絞孭（佔便宜）},狡{(白)狡詐}
geu3	kɛu55	校{(又)～數，隱語，排行最大者},鉸{(白)～牙齒，磨牙}
geu4	kɛu21	喬{(白)（木板）彎曲變形}
geu6	kɛu22	撬{撬開，撬門，源自翹，尾起也}
gi1	ki53	乩,饑{饑荒},飢{飢餓},鞿,鐖{鉤上的倒刺},錤,譏,觭{偏向、側重；同奇字，單數},虮{密虮},萁{草名},肌{肌肉，肌膚},羈,箕,禨,磯,畿,畸{(又)},璣,犄{犄角},機{飛機，機器，機會，時機},机,期{期年},幾{幾乎},姬,奇{奇數},基,嘰{嘰哩咕嚕；音譯用字，咔嘰},咭{同嘰字},剞,刏{切斷},刉{同刏字},几{茶几},其{夜如何其；古人名，酈食其}
gi2	ki33	己{自己，知己},麂,魢,踦{腳脛},蟣{蟣蝨},虮{同蟣字},紀{紀律；世紀；姓},杞,掎{掎角},庋{(又)},幾{幾個}
gi3	ki55	冀,鱀,驥,記,計{計算，統計，夥計；恁～，想辦法},覬,繼,洎,檵{枸檵，檵木},暨{及也至也；暨南},旣,既,悸,寄,妓{(語)老～婆，妓女},塈{(又)}
gi4	ki21	䓫,𨙸,𤪌,麒,鰭,鯕,鬾{小兒鬼},騏,騎{騎馬，騎兵},頎,隑{同碕字},錡{穿木鑿；三足釜},軝,跂{足多趾},衹{衹衼},蟣{水蛭},蜞,蘄,萁{豆萁},茄{(白)茄瓜，茄子},芪,耆,綦{綦巾；姓},祺,祈{祈求，祈福；千～，千萬（副詞）},祇{神祇},祁,碕,碁,琪,琦,淇,歧,棋,棊,期{日期},旗,旂{竿頭繫鈴的旗；同旗字},愭,忯{忯忯；敬也},崎{地名，長崎（在日本）},岐,奇{奇怪},埼,圻{地的邊界；姓},其{其他},俟{万俟（複姓）},伎{伎伎},亓
gi5	ki24	徛{站立；～理，整齊、整潔}
gi6	ki22	伎{伎倆},鬾{冥衣},騎{車騎，鐵騎；姓},跽,芰,汥{水分流},技,惎,忌{妒忌，忌諱，忌憚},妓{歌妓，妓女},垍
giak2	kiɐk3	嗝,鬲{鬲津，膠鬲},骼,革,隔,鎘{金屬元素},鉻{古兵器},蹻{通屩字，高～排/師，高蹺},蹺{(訓)高～排/師，高蹺，本字屩/蹻，俗字腳},茖,膈{膈膜},腳{下肢；牀腳，山腳；量詞，踢一腳},胳{胳臂，胳膊},滆,槅,格,挌{擊也},屩{草鞋；高～排/師，高蹺，俗字腳},塥
giak6	kiɐk2	噱{大笑；噱頭，俗作謔頭},臄
giang1	kiɐŋ53	姜{姓},鶊,賡,薑{生薑},耕{耕田，春耕},羹{羹湯，匙羹，調羹},粳{粳米},礓{礓石},畊,焿,更{三更},庚{年庚，庚子}
giang2	kiɐŋ33	蔃{根、莖，一說梗的音變}
giang3	kiɐŋ55	挭{攪也},逕{(白)～水，涉水，俗字浭},耿{(語)表狀態或程度，這/那樣、這/那麼，箇樣的合音，又作梗/更字},筻,浭{俗字，～水，涉水，本字逕},梗{(語)表狀態或程度，這/那樣、這/那麼，箇樣的合音，又作耿/更字}
giang4	kiɐŋ21	強{強大，堅強},蔃{蔃莍},彊{同強字}
giang6	kiɐŋ22	勥{固執，執拗},糨,犟{固執，執拗}
gik2	kek3	亟{亟待},激,殛,棘{荊棘，棘手},撠,戟{畫戟，折戟沉沙},墼
gik6	kek2	劇{劇烈；戲劇},極,极,屐{木屐}
gim1	kim53	兼{兼職，兼顧},鶼,鰜{比目魚},蒹,縑,搛{搛菜}
gim2	kim33	撿,瞼,檢
gim3	kim55	劍
gim4	kim21	扲{基業},黚{淺黃黑色},黔{黔首，黔驢技窮},鉗{(文)},鉆{同鉗字},鈐,箝{(文)}
gim5	kim24	魽{(文)}
gim6	kim22	儉
gin1	kin53	鈃{人名用字},鞬,靬
gin2	kin33	囝{閩語字，兒子},𠐻{傲慢},蹇,趼{(書)},謇,瀽
gin3	kin55	建,見{看見},腱{肌腱，腱子，讀同建},犍{犍牛，讀同建},毽{拋足之戲具}
gin6	kin22	健,鍵{關鍵，鍵盤},踺,犍{犍爲縣，漢碑作楗},楗,揵{通楗字}
ging1	keŋ53	京,麖,驚{震驚，驚慌},荊,經{經濟；經緯},矜{矜持，矜貴},猄,涇,惊{同驚字},兢
ging2	keŋ33	儆{儆戒，以儆效尤},頸,警,璥,璟,烴{溫；焦臭；焦貌},景{風景，景仰；〈語〉得意、驕傲，見廣的合音，～得，得意洋洋},擏{同儆字},憬,境,剄
ging3	keŋ55	勁{幹勁，費勁；強勁，勁敵},鏡,逕{至也，過也；同徑字},莖{根莖，讀同逕},脛,競{競爭，競賽，讀同竟},竟{究竟，竟然},獍,敬,徑{半徑，徑直，途徑},弳
ging4	keŋ21	凝{(語)（豬油等）凝結},黥,鯨,藑,瞏,瓊,璚{同瓊字},澄{(語)澄清（水、液體）},檠,擏{同擎/檠字},擎{引擎，擎天柱},嬛{美好；同煢字},勍
ging6	keŋ22	倞{強勁},痙
gip2	kip3	劫{打劫，劫匪},袷{相交的衣領},蜐,砝{硬也},澀{(訓)苦澀（形容味道），澀味，澀口，本字砝，硬也}
giu1	kiu53	嬌,驕,蹺{(又)翹腳，讀同澆},翹{(又)翹腳，讀同澆},澆,徼{抄襲}
giu2	kiu33	儌{儌行},蹻{蹻蹻},繳{上繳},矯{矯健，矯情，矯詐},皦,璬,敫{光閃耀；姓},撟,剿{(又)讀同繳}
giu3	kiu55	叫,敫{人名用字},徼{邊界；巡察}
giu4	kiu21	僑,鞽,趫,蕎,翹{銀翹，翹首},礄,橋,嶠{山尖而高},喬{喬木；姓}
giu5	kiu24	皛,藠{藠頭}
giu6	kiu22	嶠{山道},轎{轎車，花轎}
go1	ko53	哥{阿哥，哥[ko21]哥},鎶,菏{古湖名},滒,歌{唱歌，歌曲}
go2	ko33	哥{(語)鷯[leu33]哥},𠜴,餜{餅也；油～，油炸過的豆腐，圓形，俗字果},錁,裹,蜾,菓,舸,粿,笴{(又)},猓,果{水果，如果},嗰{粵字，那，本字箇，本地用爾[ȵi22]（遠指）},哿
go3	ko55	個{一個，個人},箇{量詞，枚也；代詞，這、那，古文用法}
go4	ko21	閜{(語)彎曲、捲曲，～寥[lɛu55/lau55]翹[kʰɛu55/kʰau55]，彎彎曲曲，又作閜料峭/閜嶚峭}
goek2	kœk3	嚳,鵠{鵠的},鞫,鞠{鞠養，鞠躬},鋦{鋦碗},轂,踘,谷{山谷},菊,穀{五穀；～線、～串，稻穗},牿,瀔,榖,梏,掬{雙手捧物}
goek6	kœk2	侷{侷促},鋦{金屬元素，符號Cm},跼,焗{俗字，悶，～熱，悶熱，一說本字焅，另一說本字局},局{局部，郵電局}
goeng1	kœŋ53	䢼,龔,魟{䱑魟},釭{(又)},躬{鞠躬，曲躬，躬親},蚣{蜈蚣},芎,紅{女紅},篢{篢笠},碽,玒{(又)},攻{攻擊},恭,弓,工,宮,塨,功,公{公文，辦公；阿公（外祖父），老公（丈夫）},供{供應；口供}
goeng2	kœŋ33	拱{拱手},鞏{鞏固},珙,汞{水銀；紅汞（紅藥水），藍汞（藍藥水）},栱
goeng3	kœŋ55	供{供奉，供品},𫋐{鑽，拱出，與鞠對轉},貢,嗊{嗊吥}
goeng4	kœŋ21	穹,銎,邛,跫{蹋地聲；人行聲},蛩,藭,筇,窮
goeng6	kœŋ22	共{總共}
gon4	kon21	掮{(白)扛，～上膊頭去、要膊頭～取，又作揵字},揵{(白)扛，～上膊頭去、要膊頭～取，又作掮字}
got3	kot5	嗗{(又)}
got6	kot2	嗗{(又)}
gu1	ku53	呱{呱呱墜地},鴣{鷓鴣},鍋,酤,過{古國名；姓},辜,軲{軲轆},軱,觚,蛄,菰,菇,苽,胍{胍𦘴},股{(白)屁股},罛,渦{渦河},沽,戈,孤,姑{姑母（父之姐），姑姑（父之妹，又稱阿姑）},堝,咼{姓},咕{咕嚕，咕嘟，嘀咕}
gu2	ku33	䀇{䀇子（湯皿）},𦙶,鼓,鈷,軲{(白)的[tek5]～轤[lu33]，一種遊戲，在斜板上擊銅元向前滾，以遠近決勝負},賈{商賈},詁,蠱,蛌,臌,股{股票，入股},羖,罟{網},瞽,盬{鹽池},牯,嘏,咕{花～嘟，花蕾、花骨朵},古{古代，考古；講～，講故事，～崽，小故事},估{估計，低估；猜；謎語，猜～，猜謎語，字～，字謎，開～，揭謎底}
gu3	ku55	估{估衣},鯝,顧,雇{雇主，雇員，解雇},錮{禁錮},過{過逾；過失},痼,故,崮,堌,固,僱{同雇字，僱傭，僱用}
gu4	ku21	咕{(語)死～～，死板；～咕[ku24]～，赤子陰}
gu5	ku24	咕{咕[ku21]～咕[ku21]，赤子陰}
gu6	ku22	瓠{(白)瓠子瓜，匣母讀如群母}
gui1	kui53	傀{傀奇},瑰{瑰寶}
gui3	kui55	瑰{玫瑰}
gui6	kui22	䠩{累，俗字癐/攰},癐{病也；〈語〉累，本字䠩},攰{(訓)累，本字䠩}
guk2	kok3	嘓,蟈{蟈蟈},虢{(又)},膕,漍,幗,國
gun1	kun53	倌,觀{參觀},蒄,莞{草名，可爲蓆},棺,官,冠{衣冠}
gun2	kun33	䲘,館,莞{東莞},脘{胃腔},管,筦,琯,朊{胃}
gun3	kun55	冠{冠軍},鸛,鑵,貫,觀{寺觀},罐,祼,盥,瓘,爟,灌,涫,毌
gung1	koŋ53	㿠,輄,胱,珖,洸,桄{桄榔},垙,咣,光
gung2	koŋ33	广{同廣字},獷{粗獷，獷悍},廣
gung3	koŋ55	桄{桄子；一桄線}
gut6	kut2	嗗{象聲詞，飲聲，引申作喝}
gwaa1	kʷa53	呱{頂呱呱，呱呱叫},胍{有機化合物},緺,瓜,歄{弱貌；〈語〉死亡}
gwaa2	kʷa33	剮,寡
gwaa3	kʷa55	卦{卦相，打卦},詿,褂{馬褂，大褂},罣,掛{倒掛，掛念},挂,坬,啩{粵字，語氣詞，嘅哇的合音，本地用哇[wa22]，今日冇落雨～？}
gwaa4	kʷa21	呱{(語)象聲詞，響～～}
gwaai1	kʷai53	乖
gwaai2	kʷai33	拐{拐彎；拐棍},𧊅{俗字，蛙類},蒯{(又)},柺{同枴字，柺棍},枴{枴棍}
gwaai3	kʷai55	夬,怪
gwaai5	kʷai24	㨤{同擓字},擓{舀，～水，又作㨤字}
gwaak2	kʷak3	摑
gwaak6	kʷak2	𥕏{硬～～，硬邦邦}
gwaan1	kʷan53	瘝{病也},鰥{鰥夫，鰥寡},關{關門，關心，崑崙關；姓},綸{羽扇綸巾},矜{(古)同鰥/瘝字}
gwaan3	kʷan55	慣,躀{俗字，摔，本字摜},擐,摜{扔；摔；跌}
gwaang2	kʷaŋ33	旺{(白)月～，月暈，日～，日暈，云母讀如群母，又作暀字},梗{(白)又音},暀{(白)名詞，月～，月暈，日～，日暈，云母讀如群母，即旺字，日暈}
gwaang4	kʷaŋ21	俇{俇攘},鵟,誑,狂
gwaang6	kʷaŋ22	俇{俇俇；遠行},逛{逛街，遊逛；散步，我哋～一陣子}
gwaat2	kʷat3	䒷,鴰,颳{颳風},聒{聒噪，聒耳},筈,栝{櫽；檜樹},括{包括，括號},刮{刮傷，搜刮}
gwai1	kʷɐi53	圭,龜{烏龜},鮭,閨,銈,邽,硅{非金屬元素，符號Si；由日文名珪素（荷蘭語keiaarde）而來，後改王字旁爲石},皈,珪,潙,溈,洼{姓},歸,廆{山名},嬀,媯
gwai2	kʷɐi33	佹,鬼{鬼怪，魔鬼；～兒[ȵi55]，小孩},軌,詭,簋,氿{氿泉},晷,庋,宄,姽,匭,傀{(又)傀儡，讀同鬼}
gwai3	kʷɐi55	劌,鱖{鱖魚},蹶{動也},貴,筀,癸{壬癸，癸水},炔{姓},炅{姓},桂,昋{姓},季
gwai4	kʷɐi21	喹,騤,馗,隗{姓},酅,逵,觿,蠵,蝰,葵,睽,眭{目深惡視},畦{菜畦},暌,攜,揆{(又)讀同葵},戣,奎,夔
gwai5	kʷɐi24	揆{揆度，總揆}
gwai6	kʷɐi22	匱{匱乏},饋{反饋，饋贈，俗讀同潰},餽{祭祀鬼神；姓；通饋字},跪,蕢,簣,櫃{櫃檯，櫃桶},柜{同櫃字}
gwan1	kʷɐn53	君,龜{通皸字，龜裂},麇{獐子},鵾{(文)},鮶,頵{(又)},軍,褌,莙,皸{皸裂}
gwan2	kʷɐn33	滾,𥕦,鯀,輥{輥軸},袞,緄{(文)}
gwan3	kʷɐn55	呁,𧥺{欺騙，俗字謴/棍},棍,捃{(又)}
gwan4	kʷɐn21	宭,麇{成羣},裙,群{同羣字},羣{羣體，一羣人}
gwan5	kʷɐn24	䐃{腸中脂},菌,窘{窘迫；〈語〉扭傷，～着腳}
gwan6	kʷɐn22	珺,郡
gwang1	kʷɐŋ53	肱,觥,薨{公侯之死}
gwang6	kʷɐŋ22	暀{(白)量詞，圈、繞；名詞，眼～，眼圈兒}
gwat2	kʷɐt3	䓛{(又)},鶻{鶻鵃},骨{筋骨，骨頭},餶{餶飿},蓇,滑{滑稽},汩,橘{(書)},榾
gwat6	kʷɐt2	倔{倔強；〈語〉禿、不尖，本字屈},𡲬{同屈字，短尾也},掘{挖掘，掘地},崛,屈{(白)禿、不尖，～頭巷，死衚衕，俗字倔/掘/橛}
gwe2	kʷe33	𠜴{(語)割，～草}
gwe4	kʷe21	瘸{瘸腿},蟝{(語)蠄～，蟾蜍，或與𧊅/蛙同源}
gwet2	kʷɛt3	刮{(白)用刀刮，～松油、～鍋巴，俗字擖},擖{(訓)用刀刮，～松油、～鍋巴，訓讀刮}
gwik2	kʷek3	洫,鶪,馘,闃,虩,虢{假途滅虢，虞虢；姓},綌,湨
gwing1	kʷeŋ53	坰,駉,扃
gwing2	kʷeŋ33	詗
gwing5	kʷeŋ24	冏,迥{迥然不同},絅,熲,炯,炅{火光；明亮},泂,囧
gyu1	ky53	俥{象棋紅方棋子名},駒{馬駒},車{車馬炮},裾,腒,琚,椐,据{拮据},崌,居
gyu2	ky33	弆,齲,踽,蒟{蒟蒻（即魔芋），蒟醬（即蔞葉），假蒟（即假蔞葉）},莒,舉,筥,矩{規矩},櫸,榘,椇,柜{柜柳}
gyu3	ky55	倨,鋸{〈名〉鋸子；〈動〉鋸開},踞,瞿{驚視},據{根據，據說},据{同據字},屨,妓{(語)老～寨、老～牌，妓院},句{句子，語句}
gyu4	ky21	佢{俗字，他，本字渠},𠍲{同渠字，他},鼩,鸜,鴝,軥{軛下曲者},衢,蠼{蠼螋},蠷,蟝{蛆蟝；〈語〉蠄～，蟾蜍},蘧,蕖,臞,籧,磲,瞿{姓},癯,璩{耳環；玉名；姓},灈,渠{水渠，渠道；他，俗字佢},氍,朐,劬
gyu5	ky24	岠{(又)},距{距離，差距},竘,拒
gyu6	ky22	俱{俱全，俱樂部，傢俱，讀同具},颶,鉅{艱鉅，鉅額；姓},醵,遽,詎,苣,粔,窶{貧窮},秬,犋,炬,澽,懼,巨{巨大，巨人},岠,具{具體，工具}
gyun1	kyn53	堅{堅固，堅強},鵑,鳽{鶺鴒},鰹,蠲,蜎{(語)爬着鑽},肩,絹{手絹，絹絲},焆,涓,捐,娟
gyun2	kyn33	卷{試卷，卷軸，腰卷（春卷兒）},錈,捲{捲起，捲曲，捲筒粉}
gyun3	kyn55	券{(習)票券，證券，因形近字卷轉讀見母},鄄,絹{(又)},睠{同眷字},睊,眷{家眷；眷顧},狷,桊
gyun4	kyn21	乾{乾坤，乾隆},鬈,顴{顴骨},踡,觠,蜷,虔{虔誠，虔心},犍{(又)犍爲縣},權,揵{舉也},掮{掮客；肩扛，本字𠢅/𠢍},拳{拳頭，打拳；對～、～對，猜碼口令，數字零},惓{惓惓},婘{美好貌},墘
gyun6	kyn22	件{一件，條件},圈{豬圈},倦
gyut2	kyt3	㛃,鮚,袺,結,拮{拮据},䥛{鐮刀}
gyut6	kyt2	偈{武貌；疾馳},絜{清也，後作潔},潔,洁,橛{量詞，截，又作橜字},榤,桀,杰{人名用字；同傑字},傑{傑出}
haa1	ha53	吓{嘆詞},𨉣{𨉣腰},閜{大開},鉿{金屬元素，符號Hf},蝦{魚蝦},瘕{絣（掹）～，哮喘；喉～，嗓子沙啞},岈{㟏岈},哈{哈哈笑；哈巴狗；哈腰，同𨉣腰；姓}
haa4	ha21	㗇{咽也},霞,遐,蝦{蝦蟆，又作蛤蟆},蛤{蛤蟆，同蝦蟆},瑕,哈{(又)～一口氣},叚{通瑕/遐字；姓}
haa5	ha24	奤{奤夿屯}
haai1	hai53	咍,開{開門，打開；全～手、～清手，猜碼口令，數字十},鐦,嗨{嗨喲},咳{嘆詞}
haai2	hai33	海,醢,胲{有機化合物}
haai4	hai21	偕{(又)讀同諧},骸{骸骨，屍骸},頦,鞋,諧{和諧，諧音，詼諧},孩,嚡{俗字，使東西從嘴裏出來，本字咳},咳{嬰兒笑；〈語〉使東西從嘴裏出來，俗字嚡}
haai5	hai24	懈{鬆懈，懈氣},邂,觟{觟䚦},蟹{螃蟹，青蟹，花蟹},薢{(又)},獬,澥,檞{(又)}
haai6	hai22	亥,齘{(又)},駭{驚駭},解{曉也、姓，俗讀解開之解},薤,瀣,氦,械{(又)},廨,害,嗐{大開口；嘆詞}
haak2	hak3	殼{蛋殼；地殼},郝{姓},蠚{螫也},熇{熱貌，與炕對轉}
haak6	hak2	學{上學，學生},鷽,鶴,隺,貉{貉子，貉絨},翯,斆{學},斅{學},嶨
haam1	ham53	坩,魽{同蚶字},酣{酣睡},蚶{蚶子，毛蚶},憨{憨厚}
haam2	ham33	㘚,顑,闞{虎聲},轗,莰,磡{(又)高而險，幾近垂直的河岸，～頭、塘～、江～；地名，龐屋～},欿{貪},墈{(又)地名，龐屋～},埳,坎{(白)舂～，石臼},喊{喊人，大喊}
haam3	ham55	墈{險岸；邊緣，塘～、江～},闞{姓；犬聲},磡{巖崖之下},崁
haam4	ham21	函,鹹{鹹淡，鹹魚，鹹菜},魽{蛤},銜,酣{(又)},諴,琀,焓,涵,浛,晗,嵅,崡,啣,唅{通含/琀字},咸{咸豐，咸陽，老少咸宜},咁{同銜字},含
haam5	ham24	撖{姓},頷,菡
haam6	ham22	㽉{大瓮},餡{餡料，肉餡，餡餅},陷,撼{震撼，撼動},憾{遺憾}
haan1	han53	慳{節省，～攢，積攢},頇,羥{羊名},看{看守，看管},掔
haan2	han33	侃,蔊{(又)},罕{稀罕，罕見},刊{報刊，刊誤}
haan3	han55	厂{山石之崖},衎,看{看見，看法},熯{火乾},漢,暵
haan4	han21	嫺{嫺熟，嫺靜},鷴{同鷳字},鷳{白鷳},韓,閒{得閒，清閒，閒置},閑{防閑；通閒字，清閑，閑置},邯{邯鄲},邗,豻{駝鹿},虷{井中赤蟲},癇,犴{駝鹿},汗{(古)可汗，汗國},榦{井欄},寒,嫻{同嫺字}
haan5	han24	旱{乾旱，旱災}
haan6	han22	垾,鼾,限,銲{同焊字},釬{同焊字},豻{(又)野狗},蔊{蔊菜},莧{莧菜},翰{翰林，翰墨},粯,硍,矸{磓},犴{(又)狴犴},焊{焊接，電焊},瀚,汗{出汗},旰{皓皓旰旰},捍,扞{扞格；同捍字},悍
haang1	haŋ53	夯{石夯，夯實},糠{米糠，糟糠；糠蘿蔔},穅{穀皮，後作糠},砊{雷聲}
haang2	haŋ33	酐{苦酒}
haang4	haŋ21	䘕,頏,降{投降},迒,行{銀行，行列，排行},航,肮{喉嚨},絎{刺縫},笐{樂器},沆,桁{刑具},杭,吭{引吭高歌}
haang6	haŋ22	巷{街巷，巷戰；地名，石巷口},項{項目，項鏈；〈語〉～雞，小母雞，疑本字笐，竹列也},衖{同巷字，街巷},行{次第},笐{衣架；〈又〉竹列},桁{衣架}
haap2	hap3	䆟{合也},𫈰,袷{袷袢},磕{磕碰，磕頭（口語稱叩頭），與扻對轉},狹{狹窄，狹義},洽{洽談，融洽，讀同恰},欱{大口喝；打～浪，打哈欠},掐{掐住，掐指},挾{(又)讀同狹},恰{恰當，恰似},峽{峽谷，海峽},嗑{嗑然而笑},呷{吸飲},匼{匼匝；匼河（在山西）}
haap6	hap2	俠,𬌗,餄{餄餎},頜{上下頜},陜,闔,鉿{鉿匝，同匼匝},郃,耠,翈,篋{書篋，籐篋},硤,盒{禮盒，菸盒},盍,狎,烚{火貌},炠,溘,柙{藏獸檻},搕{敲擊；取},峇{岌峇},嗑{噬嗑；閒嗑；嗑瓜子},合{合作},匣{匣子，木匣}
haat2	hat3	喝{喝酒；喝采},鶡,餲{餅類食品},鞨{鞋；靺鞨},褐,蝎{木中蠹蟲},渴{口渴，渴望},曷,愒{恐嚇}
haat6	hat2	嗐{大開口},轄{管轄}
haau1	hau53	哮{咆哮，哮喘},骹{小腿},鄗{古山名},虓,薅{薅草，薅鋤},蒿{蓬蒿，茼蒿},茠{同薅字},礉{同䂭/磽字},磽,猇,毃,敲{敲門，推敲},嚆,嘐{誇語；啁嘐}
haau2	hau33	好{好壞},巧{(文)}
haau3	hau55	傚{倣傚},酵{發酵，酵母，讀同孝},耗{消耗，耗費},秏,礉{石不平貌},滧,涍,校{(又)學校},斆{教導},斅{教導},效{成效，效果},孝{孝順，戴孝},好{喜好}
haau4	hau21	嗥,豪,蠔,蚝{同蠔字},號{呼號，嚎的本字},濠,毫,姣{淫蕩、輕浮},壕,嚎{狼嚎，嚎啕，本字號}
haau6	hau22	恔{暢快},顥,鎬{鎬京},鄗{古地名},號{號碼},皞,皓,灝,滈,淏,浩,昊
hai1	hɐi53	㞓{女陰（即谿，山間河），也作程度副詞，俗字閪；詈語，癡～，神經病，戇[wɐŋ22]～，笨蛋；亞隻～人，梗[kiɐŋ55]難講，這傢伙這麼難說話},閪{俗字，女陰，也作程度副詞，本字㞓（即谿，山間河）},谿{女陰，今作㞓}
hai2	hɐi33	呇{明亮的星},喺{粵字，在，本字在，本地口語用在},啟{同啓字},啓{啓發，啓動}
hai3	hɐi55	與{(白)給，上古魚部，俗字許},許{(語)給，本字與，上古魚部}
hai4	hɐi21	傒{(文)},鼷{(文)},騱{(文)},郋,蹊{(文)蹊徑},豀{(文)},徯{(文)},嵇{(文)},奚{(文)},兮
hak2	hɐk3	黑,𨭆
ham1	hɐm53	嶔,顉{曲頤；低頭也},鑫,歆,欽,廞
ham2	hɐm33	𧾏
ham4	hɐm21	唅{(語)詞綴，衝～～，紛紛衝貌，喢～～，（狗）很兇}
ham5	hɐm24	扻{磕、碰，～着頭喇，與磕對轉}
ham6	hɐm22	冚{～唪唥，全部，一說本字咸；冚唪唥也是猜碼口令，數字十，也說開清手、全開手}
han1	hɐn53	忻,訢{同欣字；姓},焮,炘,欣{欣賞，歡欣；〈語〉玩，去～，去玩，講～笑，開玩笑},昕
han2	hɐn33	墾,齦{啃},豤,詪,狠,懇,很
han3	hɐn55	舋{同釁字},釁{挑釁},衅
han4	hɐn21	拫,痕{傷痕，痕跡；〈語〉癢}
han6	hɐn22	恨{仇恨，怨恨，恨事}
hang1	hɐŋ53	亨{亨通，大亨；姓},鳽{鵁鶄},鏗{(文)},脝,硜,摼{敲打},啈{嘆詞},哼{哼唱},吭{不吭聲}
hang2	hɐŋ33	肯{肯定，中肯}
hang3	hɐŋ55	炕{烘烤，～火，烤火，與熇對轉；身～，身體發燙；臊～～，臊味或羶味很濃}
hang4	hɐŋ21	姮,鴴,衡{平衡，衡量},蘅,緪{(語)繃緊，亞條索拉～啲，（液體或含水分的東西）遇冷凝結，亞啲豬腳湯～成凍喇，讀聲符恆，俗字衡/拫/恆},珩,桁{桁條，瓦桁},恒,恆{永恆，恆心；〈語〉繃緊、（液體或含水分的東西）遇冷凝結，本字緪，讀聲符恆}
hap3	hɐp5	瞌{瞌睡},𧬈{欺負}
hat2	hɐt3	乞{乞討，乞求},迄{迄今},訖{通迄字；〈又〉收訖，讀同乞},汔{庶幾},忔{喜也},屹{(又)屹立，讀同乞},仡{仡佬族，讀同乞}
hat3	hɐt5	乞{(又)乞兒，乞飯}
hat6	hɐt2	劾,齕{齧也},黠{狡黠，黠慧},閡{隔閡},覡,覈{覈對，審覈},葜,翮,紇{回紇},礉{苛刻、嚴峻；同覈字},檄,核{核桃，核心，核武器；同覈字},搳{擖也}
hau1	hɐu53	候{(白)盯着、俟機，俗字睺},齁{鼻息也；～病，哮喘病},睺{俗字，盯着、俟機，本字候}
hau2	hɐu33	口,後{(語)～老孃，繼母},吽{同吼字},吼{吼叫，怒吼}
hau3	hɐu55	䍍{(白)鐵～，鐵勺；～殼蛇、～勺蛇，眼鏡蛇},怐{(白)戇[wɐŋ22]～～，呆呆傻傻}
hau4	hɐu21	侯{諸侯；姓},骺,餱,鍭,篌,睺{半盲},瘊{瘊子},猴,喉{喉嚨，咽喉；～急，心急、着急；～瘕，嗓子沙啞}
hau5	hɐu24	厚,垕{同厚字；姓}
hau6	hɐu22	候{守候，等候},鱟,鮜,郈,逅,茩,後{先後，後來},堠,后{皇后}
he4	he21	㗾{(語)唏[hi21]哩[li21]～咧[le21]，喘氣聲},嘻{(又)笑～～，笑嘻嘻}
hem3	hɛm55	㘚{(又)},喊{(又)東喊西喊}
hen1	hɛn53	慳{(白)節省；歇息}
hen2	hɛn33	蜆{(白)蜆子，蜆肉}
hen5	hɛn24	齦{(白)啃，老鼠～}
hep3	hɛp5	欱{(又)吮吸，～湯}
het2	hɛt3	喝{(白)嚇唬地叫喊，～兩聲，渠停住喇}
het6	hɛt2	勩{(訓)器物磨損，疑本字䃒/礉}
heu1	hɛu53	橇{雪橇},蹻{同蹺字},蹺{蹺腳（翹二郎腿）},翹{翹腳（翹二郎腿，本字蹺）；擔竿兩頭～，扁擔兩頭翹},繑
heu3	hɛu55	耗{(白)缺破、殘缺，亞把刀斬～口喇、渠牙齒～啊}
hi1	hi53	俙,鱚,魌,釐{同禧字},醯,郗{骨節間；姓},豨,譆,誒{可惡之辭；強笑},羲,絺{(又)},稀,禧,睎,琋,犧,爔,熹,熙,烯,浠,欺,欷,榿{榿木},曦,晞,希,巇,嬉{嬉戲，嬉笑},娭{通嬉字},嚱,嘿{嘆詞；象聲詞，笑嘿嘿},嘻{嘻哈，嘻嘻},唏{唏噓},兮{(又)},僖
hi2	hi33	呇{(又)},𨭎,起,豈,蟢{蟢子},芑,玘,暿,憙,屺,囍,喜,啟{(又)},啓{(又)}
hi3	hi55	㞓{臀部；身體斜坐},餼,繫{聯繫，維繫；繫鞋帶，古讀同計},系{系統},禊,炁,汽,氣{空氣，氣人},气{同氣字},棄,摡{取也},戲{戲劇},憩{憩息，休憩},愒{同憩字},屭,屓,塈,器,咥{大笑貌},係{關係；是（口語用是）}
hi4	hi21	唏{(語)～哩[li21]㗾[he21]咧[le21]，喘氣聲},嘻{(又)笑～～，笑嘻嘻}
hiak2	hiɐk3	吓{同嚇字},赫{赫赫有名，顯赫},諕,揢{以手把着},客,嚇{嚇一跳；恐嚇},喀{喀斯特，喀秋莎}
hiak6	hiɐk2	垎
hiang1	hiɐŋ53	薌{穀香},香,鄉{鄉村，故鄉}
hiang2	hiɐŋ33	䖮,饗,餉{軍餉},響,蠁,晌{晌午},垧,亯,享
hiang3	hiɐŋ55	向{向前，方向},珦,曏{從前},嚮{嚮導，嚮往}
hiang4	hiɐŋ21	行{行路，步行，行爲；品行，古讀去聲}
hiang6	hiɐŋ22	倖{倖免，倖存},悻,幸{幸福，榮幸},婞,堼
hik2	hek3	吃{吃飯，小吃，本字喫},易{交易},喫{喫飯，俗字吃}
him1	him53	忺{高興；舒適},鍁{同杴字},謙,薟{豨薟；辛味},磏{地名，大磏（在貴州）},杴{農具名，又作𣔙/鍁字}
him2	him33	嶮,險,肷,玁,獫
him3	him55	慊{不滿、怨恨，古讀上聲},芡{芡實，勾芡},歉{道歉，歉意},欠
him4	him21	嫌{(白)}
hin2	hin33	蜆{(文)蜆木}
hin4	hin21	涎{垂涎}
hing1	heŋ53	卿,馨,輕{輕鬆，輕重，輕敵},興{興旺},氫{氫氣，氫彈}
hing3	heŋ55	㷫,謦,詗{(又)},莕,荇,興{高興},罄,綮{肯綮},磬{鐘磬},杏,敻{遠},慶,夐{遠}
hing4	heŋ21	刑,陘{井陘},鉶,鈃{古酒器},邢,贏{輸贏},籯,硎,瀛,形,嬴,娙,型
hip2	hip3	勰,脅{兩脅，威脅},挾{挾持，要挾},慊{滿足},愜,怯{畏怯},叶{同協字，叶韻},協{協助，妥協}
hiu1	hiu53	嘵,鴞,驍,梟,枵,囂
hiu2	hiu33	僥{僥倖，讀同曉},曉,徼{徼倖，也作僥倖},儌{同僥字}
hm1	hm53	噷
hng6	hŋ22	哼{嘆詞},啈{發狠聲}
ho1	ho53	㰤{同呵字},訶,嚯,嚄{嘆詞},呵{呵欠，呵斥；地名，呵叻（在泰國）}
ho2	ho33	呵{(語)哦～兵，戲曲中跑龍套的兵卒，又作嗬字},嗬{(語)哦～兵，戲曲中跑龍套的兵卒，又作呵字}
ho3	ho55	和{(語)暖～～，暖烘烘}
ho4	ho21	何,龢,蚵,菏{地名，菏澤（在山東）},荷{荷花；薄荷，又作蔢𦽅},河,嗬{嘆詞；象聲詞；～哆[te55]，嗩吶},和{和平，和氣；和麪}
ho5	ho24	呵{(語)吆喝牛的用語}
ho6	ho22	和{附和，唱和},賀,荷{荷載，負荷}
hoe1	hœ53	㗾{吐氣聲},靴,吙{(又)本讀}
hoe4	hœ21	㗾{象聲詞}
hoek2	hœk3	哭
hoek6	hœk2	斛,鵠{鴻鵠},觳{觳觫},縠,槲
hoeng1	hœŋ53	倥{倥侗},訩,胸,箜,空{空虛，天空},硿,烘{烘乾},洶,悾,崆,埪,哅,哄{亂哄哄，哄堂大笑，一哄而散},匈,凶{吉凶},兇{兇惡}
hoeng2	hœŋ33	倥{倥傯},嗊{羅嗊},哄{哄騙，哄勸}
hoeng3	hœŋ55	嗅{(又)用鼻聞},齅{(又)},空{抽空，得空；空缺}
hoeng4	hœŋ21	吰,黌{黌舍，黌門},鴻,魟{海鰩魚；淡水鰩魚},雄,閎,鋐,鉷,谼,訌{內訌，訌亂},虹{彩虹，霓虹},蕻{雪裏蕻},葓{同葒字},葒{葒草},苰,耾,翃,紘,紅{紅色},竑,硔,玒,洪,泓,弘,宏
hoeng6	hœŋ22	哄{同鬨字，起哄},鬨{起鬨，內鬨},蕻{菜薹},澒
hon2	hon33	款,窾
hu1	hu53	乎{同呼字},髁,軤,科{理科，科學},烀,滹,枯{乾枯，枯萎，枯竭},挎{執持},戲{(古)於戲},幠,嘑{同呼字},呼{呼吸，歡呼，嗚呼},刳
hu2	hu33	伙{伙食，傢伙，包伙},鈥,虎{老虎；姓},苦{辛苦，苦瓜},祜,琥,火{着火，火車},滸{水滸},夥{夥伴，合夥，小夥子},唬,吙{吐氣；吐氣聲}
hu3	hu55	嘑{嘑爾},貨,褲,袴,虎{馬虎},絝,戽{戽水，戽斗},庫
hu4	hu21	乎{幾乎，在乎；〈語〉貌[ma53]～，副詞，頗、蠻，貌似乎之省且語流音變，俗作嗎胡},龢{(又)},鶘,鬍{鬍鬚},餬{餬口},醐,衚{衚衕},蝴,葫{葫蘆},胡{胡琴},糊{糊塗，芝麻糊},禾{禾苗，禾稈（稻稈），禾鐮（鐮刀）},盉,瓠{瓠蘆，同葫蘆},瑚,猢,狐,煳{燒煳，烤煳},湖,弧,壺,啝,和{打麻將和牌，又作胡牌；〈又〉和氣，和尚}
hu6	hu22	互{互相，相互},鱯,鄠,護,瓠{瓠瓜，瓠子},濩{布散},滬,枑,昈,扈,戶,怙,岵,嫭,冱
hui1	hui53	咴,顝,豗,詼,虺{虺隤},盔{(又)},灰,悝{嘲笑；詼諧},恢
hui2	hui33	悔,鮪,賄{賄賂，受賄},痏,洧
hui3	hui55	喙,餯,顪,靧,誨{教誨},晦{晦暗，晦氣}
huk6	hok2	惑,瓠{瓠落},或{或者，或許}
hun1	hun53	嚾{同歡字},髖,貛,獾,歡,寬{寬敞，放寬，與闊對轉}
hung1	hoŋ53	塃,謊{說謊，謊話},荒,肓,慌
hung2	hoŋ33	幌,謊{(又)},滉,榥,晃{晃眼；搖晃},恍,怳
hung3	hoŋ55	吽{唵嘛呢叭咪吽}
hung4	hoŋ21	亡{死亡，亡故},黃,鰉,餭,隍,鐄{大鐘},鍠,遑,蟥{螞蟥},蝗,艎,簧{彈簧},篁,磺{硫磺，磺胺，磺化反应},皇,癀,璜,瑝{玉聲},王{王朝},煌,潢,湟,惶,徨,媓,喤,凰
hung6	hoŋ22	旺{興旺，旺盛；〈語〉捧場，渠娶老婆我哋去～哈下（捧捧場）},王{(古)王天下},暀{同旺字}
hut2	hut3	眓,𨓈,闊{開闊，闊別，與寬對轉},适{疾速},豁{豁然},蛞{蛞蝓，蛞螻},筈{(又)}
hyu1	hy53	吁{長吁短嘆},訏,虛,盱,歔,旴,墟{廢墟，墟市},圩{同墟字},噓{吹噓}
hyu2	hy33	冔,詡,許{允許，許多},珝,栩,姁,喣,咻{噢咻}
hyu3	hy55	去{來去},酗{酗酒},煦,昫
hyun1	hyn53	儇,𨟠,鶱,騫,鋗,軒{軒昂，軒轅},譞,諼,諠,諐,褰,蝖{蝖螜},萱,翾,縴{縴夫},禤,祆,牽,煖{同煊字},煊,烜{(又)},汧,棬,暄,晅,攐,搴{取也},掔{(又)},掀{掀起，與揭對轉},愆,岍,嬛{便嬛},壎,塤,圈{圓圈；〈又〉豬圈},喧{喧譁，喧鬧},咺{顯著}
hyun2	hyn33	㬎,顯,遣,譴,繾,畎,甽{同畎字},犬,烜,櫶{櫶木，即蜆木},暅{日氣},咺{兒啼不止},䘆{蚯蚓（口語用土䏰[ȵyn22]）}
hyun3	hyn55	券{(書)},蜆{(常)蜆木，俗字櫶，讀同憲},綣,絢,獻{貢獻，獻出；～世，丟臉、出醜，源自現世},櫶{(常)櫶木，讀同憲},楦{同楥字，鞋楦，楦頭},楥{楥子，楥頭},敻{營求},憲,夐{營求},勸
hyut2	hyt3	吷{小聲也},血,蠍{(文)},蝎{(文)},歇{歇息，停歇},挈{(又)帶～，提攜、關照}
iak2	∅iɐk3	厄,餩{噎聲},阨,鈪{粵字，鐲子，本字軛},軶,軛{牛軛；鐲子，俗字鈪},蚅{烏蠋},苊,搤{同扼字},扼,戹,啞{啞然失笑},呝{雞聲},呃{雞叫聲，本字呝；呃逆，本字餩}
ik2	∅ek3	億,螠{縊女},臆,膉,肊{氣滿},繶,益,抑,憶,嗌{咽喉}
ing1	∅eŋ53	嚶,鸚{鸚鵡},鷹{老鷹（口語稱蒙鷹）},鶯{黃鶯},鍈{(又)},鉠{(又)},蠅{蒼蠅，蠅拍；蠅頭小利，蠅營狗苟},蘡,英,膺,纓,瓔,瑛,櫻{櫻桃},攖,應{應當，應該},嬰,媖
ing2	∅eŋ33	影{影響，電影；～像，照相},癭,映{反映，放映}
ing3	∅eŋ55	應{答應，應用}
jaa1	ja53	丫{(又)},啞{咿啞；同呀字},呀{嘆詞；象聲詞},吖{象聲詞},吔{語氣詞，哎～，表驚歎}
jaa4	ja21	呀{(又)嘆詞}
jaa5	ja24	下{一下，等下},雅,疋{通雅字},吔{(外)威～，鋼絲，英語wire},吓{同下字},厊
jaa6	ja22	下{底下，下山，鄉下，地下},暇,廈{大廈；廈門},射{僕射},夜{(白)夜晚，半夜，宵夜},夏{春夏；姓}
jaak3	jak5	吔{(又)語氣詞，哎～},咋{(白)㕭[jau53]㕭[jau53]～～，吵吵嚷嚷}
jaam3	jam55	滲{(白)又音}
jaang1	jaŋ53	韌{(語)孩子貪玩}
jaap2	jap3	挾{(又)讀同狹},眨{(白)眨，～～眼},狹{(又)}
jaap6	jap2	擛{(白)搧[ʃin53]～～，來回搧動}
jaat2	jat3	瞎
jaat6	jat2	軋{(語)（建築物等）下陷，牆腳～喇}
jaau1	jau53	㕭{～咋[jak5]，吵嚷}
jaau3	jau55	㕭{咿[ji55]～，不認真，當源自咿嚘（吟詠聲）或咿咬（稚嫩聲）},滧{(又)},效{(又)效果},傚{(又)}
jaau6	jau22	棹{(白)划，～過，掠過},櫂{(白)划，～過，掠過}
jai4	jɐi21	𠯋{俗字，壞的、差的，疑本字𢶀，損也}
jai6	jɐi22	㹭,跩{同跇字},跇{踰也；跳也},枍,曳{搖曳，拖曳，曳引},拽{同抴/曳字，拖、牽引},抴{拖、牽引，後作曳},勩{(又)}
jak2	jɐk3	簎{(白)引逗，～鬼崽，逗小孩；撩、撥，要筷子～亞條人參出來}
jak3	jɐk5	吔{(又)語氣詞，哎～}
jak6	jɐk2	掝{(語)浮[pɐu21]游踣～，工作不穩定，無工做而游逛}
jam1	jɐm53	喑{喑啞，喑默},音,陰{陰天，光陰；劉～，額前髮、劉海},蔭{樹蔭；姓},瘖,愔
jam3	jɐm55	喑{喑噁},蔭{蔭庇，蔭涼},窨{窨井},滲{(白)又音},廕{廕庇}
jam4	jɐm21	冘{冘冘},霪,簷{(白)},淫,檐{(白)屋檐，瓦檐},崟,吟{呻吟，吟詩}
jan1	jɐn53	凐{(白)涼}
jan4	jɐn21	夤,寅
jan5	jɐn24	允{(又)},蚓,縯{引},穎{(又)},癮,潁{(又)},戭{長槍},引,尹{(又)},吲{吲哚},听{笑貌},刃{(又)}
jan6	jɐn22	胤
jap2	jɐp3	㬤,邑,裛,翕{翕動，翕然},熠{熠熠，熠耀},潝,湆,浥{溼潤},揖{作揖，揖讓},挹,悒{悒鬱},唈,入{(白)～落去，縮進去，～頭～腦，縮頭縮腦、探頭探腦，～沕子，潛泳}
jap3	jɐp5	熠{(白)躲～～，躲躲閃閃}
jap5	jɐp24	入{入口，進入}
jap6	jɐp2	入{(白)慢慢沉沒，亞條船～喇}
jat2	jɐt3	逸{(白)～屎，大便失禁}
jat6	jɐt2	佚,鎰{二十兩爲一鎰},逸{逃逸，安逸},軼,肸{肸蠁},溢{滿溢，溢出},昳{昳麗},佾
jau1	jɐu53	丘,麀,鵂,髹,邱,貅,蚯,茠{同休字},耰,憂,悠{(又)悠閒，又作優閒},庥,幽,坵,嚘,咻{喧鬧},呦{呦呦},優,优,休
jau2	jɐu33	蚴{蚴虬},黝{黝黑，黝黯}
jau3	jɐu55	幼{年幼，幼兒；〈語〉細，～沙},誘,蚴{毛蚴，尾蚴},珛
jau4	jɐu21	㘥,鯈,鮋,魷,鞣,鈾,郵,遊{旅遊，遊戲},輶,輮,蹂,蝤{蜉蝤；〈又〉蝤蛑},蝣,蚰,蕕,莜{莜麥},繇{通由字},糅{糅合},粈{同糅字},疣,由,猷,猶,游{游泳，上游},浟{水流貌},油,柚{柚木},柔,攸,揉,悠{悠久，悠閒},尤,尢{姓；同尤字},囮{(又)},冘{冘豫，同猶豫}
jau5	jɐu24	卣,銪,酉,莠,羑,牖,槱,有,戭{長盾},友{朋友，老友，友崽（後起詞）}
jau6	jɐu22	佑,鼬{黃鼬},釉{彩釉，釉面},祐,狖,柚{蜜柚，沙田柚，柚子},宥,囿,右,又,侑
je3	je55	胾{(白)又音，搭秤～，帶犢兒}
je4	je21	倻,鋣,邪{莫邪，琅邪；古同耶},耶{耶穌；通爺字；語氣詞},琊,玡,爺{爺爺[je24]，老爺；父也},椰,揶
je5	je24	也{也是，也許},野,冶
je6	je22	夜{(文)夜來香，夜摸（夜間賊），夜關門（決明子）}
jet2	jɛt3	抴{(白)搖搖～～，搖搖蕩蕩},曳{(白)搖搖～～，搖搖蕩蕩，本字抴}
jet3	jɛt5	逸{(白)躍起，～過}
ji1	ji53	伊,𣐿,黟,餏{量詞，讀同衣},銥,醫,衣{衣服，雨衣，衣車（縫紉機）},蛜,繄,禕,猗{美盛貌；讚美},漪,洢,欹{同猗字，讚美},嫛,噫,咿{咿唔，咿呀},依{依靠，依然}
ji2	ji33	倚{倚靠，不偏不倚},齮,錡{懸掛弓弩的兵器架},踦{抵住},綺{綺羅，綺麗，讀同倚},犄{去勢的公牛},椅,旖,扆
ji3	ji55	咿{(語)～㕭[jau55]，不認真，當源自咿嚘（吟詠聲）或咿咬（稚嫩聲）},饐,鐿,衣{(古)穿（衣服）},薏,肄{肄業},翳{(白)～燈，熄燈},癔,瘞,殪,懿,意
ji4	ji21	匜,𧦧,鴯,鮞,飴{飴糖},頤,陑,鉹{(又)},酏,遺{遺失},迻,迤{同迆字，逶迤},迆{逶迆},貽,誃{門名；臺名},詒{贈送},袲,螔,蛇{虛與委蛇},荑{莁荑；芟刈},胹{爛也；煮也},胰,耛,耏{頰鬚；地名用字},而{(白)然而，而今},羠,簃,移,眙{盱眙},痍,洏,沂{沂河},椸,栘,杝{椴木},扅,怡,彞,彝,异{發歎詞},峏,宧,姨{姨媽（母之姐），姨丈，阿姨},夷,圯,咦,台{我也；同怡字}
ji5	ji24	以,阤{阤靡},迤{同迆字，迤邐},迆{迆邐},苢,苡,矣,已,咦{(又)},佁{癡；靜}
ji6	ji22	勩{勞也},食{古人名，酈食其},異{差異，異常},潩,易{容易},异{舉也；同異字},廙
jiak2	jiɐk3	約{約定，預約；用秤稱},葯{白芷}
jiak5	jiɐk24	偌{偌大},龠,鑰{鑰匙},鄀,躍{跳躍，躍進},藥{草藥，藥片},葯{同藥字},若{若是},籥,箬,爚,瀹,櫟{櫟陽},婼{婼羌}
jiang1	jiɐŋ53	咉,鴦{鴛鴦},鞅{馬頸革；鞅掌；商鞅},陽{姓},鍈{同鉠字},鉠{鈴聲},秧,泱{泱泱},殃,央
jiang2	jiɐŋ33	怏,鞅{牛鞅；鞅鞅},抰
jiang3	jiɐŋ55	撐{(白)蹬、踹}
jiang4	jiɐŋ21	佯{佯裝，佯攻},颺,陽{太陽},鍚,蛘{米象},羊,瘍{潰瘍},痒{病也},瑒{玉名；花名},煬,烊{熔化；打烊},洋,楊,暘,揚{揚手，宣揚},徉{徜徉，彷徉},垟
jiang5	jiɐŋ24	氧,養{養育；供養，古讀去聲},蛘{通癢字},癢{撓癢，瘙癢},痒{同癢字},瀁
jiang6	jiɐŋ22	恙,羕,漾,樣{樣板，模樣}
jik5	jek24	㑊,驛,釴,譯,蜴,腋{腋窩},翼,翌,翊,繹,睪{伺視},燚,熤,液,杙,掖,懌,弋,弈,嶧,射{無射},奕,埸,亦{亦有，亦可}
jim1	jim53	㤿{～憸，愛挑剔},閹,醃{(文)},腌{(文)},淹,懨,崦,奄{奄奄一息}
jim2	jim33	㜝{美},𥀬{痂},龑,黶,魘,罨,演{(習)表演，演員},渰,掩,弇{蓋也},奄{奄有，奄忽},厴{蟹腹下甲；螺殼口圓片蓋；衣兜上的蓋兒，荷包～}
jim3	jim55	俺{大也},饜,覎,厭
jim4	jim21	嫌{嫌棄，涉嫌},鹽{食鹽；醃},阽{(又)},閻,閆{姓},芫{(習)芫荽},簷{同檐字},炎,檐{屋檐，瓦檐；～蛇，壁虎}
jim5	jim24	剡{銳利，削尖},琰,棪,染{(又)},扊
jim6	jim22	掞{照耀},豔{鮮豔，豔麗},艷{同豔字},爓{同焰字},燄,焱,焰{火焰，焰火},灩{瀲灩}
jin1	jin53	鴛{(又)}
jin2	jin33	偃{偃臥，偃旗息鼓},鼴,鶠,郾,躽{身向前也},衍{敷衍，衍生},蝘,縯{長},演{(書)},戭{人名用字}
jin5	jin24	俔{譬喻},睍{小目貌},甗,沇,巘{峭巘，巘崎},兗
jin6	jin22	讞,齴{同齞字},齞{露齒貌}
jing4	jeŋ21	滎{滎陽；滎經},螢,熒
jing5	jeŋ24	郢
jing6	jeŋ22	媵
jip2	jip3	擪{指按也},靨{笑靨，酒靨},醃{(白)醃肉，醃製},腌{(白)同醃字},擫{同擪字}
jip5	jip24	䈎,饁,頁{扉頁，頁碼，本字葉},葉{樹葉，葉子；姓},燁,楪{窗牖},曄,擛{動貌},擖{箕舌},揲{箕舌}
jit2	jit3	䊦{糉屬},黦{色壞也},謁,蠮{蠮螉},噎{噎住，因噎廢食}
jit6	jit2	抴{(又)},拽{(又)同抴字}
jiu1	jiu53	㙘,邀,要{要求；姓},腰,徼{同邀字},幺{幺二三},妖,夭,喓,吆{吆喝},么{同幺字}
jiu2	jiu33	杳{(又)本讀},窈{(又)本讀},窅
jiu3	jiu55	要{重要}
jiu4	jiu21	僥{(古)僬僥},鰩,饒,颻,陶{古人名，皋陶},銚{大鋤；姓},遙,軺,謠,蟯,蕘,繇{通徭/謠字},窯,瑤,珧,猺,洮{湖名},橈{楫也},搖,徭,嶢,嬈,媱,姚,堯,垚
jiu5	jiu24	崾,遶,舀{舀水},繞{圍繞；繞線},擾,扰
jiu6	jiu22	曜,鷂{鷂鷹，紙鷂},耀,燿
jo1	jo53	唷{嘆詞},喲{嘆詞}
jo5	jo24	喲{(語)表驚訝}
joek2	jœk3	勖,頊,隩{河岸彎曲處},郁{馥郁；姓},薁,燠{熱；暖},旭,彧,勗{同勖字}
joeng4	jœŋ21	傭{傭工，僱傭},𣭲{同氄字},鱅,鰫,髶{髮亂},顒,鏞,鎔{鑄器模型；鎔鑄；鎔化},鄘,蠑,融,蓉,茸{鹿茸，蒜茸，毛茸茸},肜,絨{絨毛，呢絨，燈芯絨},瑢,狨,熔{熔化},熊{狗熊，熊貓},溶{溶解，溶劑},氄{氄毛},榮{光榮，榮幸},榕,搑{擣也},戎,慵,庸,嶸,容,宂{(又)},墉,喁{魚口向上},冗{(又)}
joeng5	jœŋ24	俑,𣭲{(又)},鯒,踴{同踊字},踊{踊躍},蛹{蠶蛹},甬{甬道},湧{同涌字},涌{涌現，泉涌},氄{(又)},恿,宂{宂長，撥宂},埇{道上加土；地名},勇,冗{同宂字，冗長，撥冗}
joeng6	jœŋ22	㶲,用,佣{佣金，佣錢}
jot2	jot3	黦{(語)能力差，渠幾～}
jui5	jui24	銳{(又)},鋭{(又)}
jui6	jui22	芮{(又)},裔,蜹,蚋
jyu1	jy53	于{同於字},迂,紆,淤{淤泥，淤積},於{於是，終於；姓},吁{(又)讀同於/迂}
jyu2	jy33	傴{傴僂},瘀{瘀血，瘀傷；（菜等）受擠壓而損傷},嫗,噢{噢咻}
jyu3	jy55	燠{燠休},飫
jyu4	jy21	与{同歟字},魚{(又)},髃,餘{剩餘},顬,雩,隅,隃,銣,邘,遺{(又)},逾{逾期，逾越，過逾},輿,踰,諛,覦,襦,褕,蠕,蝓,虞,薷,萸,茹,艅,舁{擡},臾,臑{嫩軟貌},腴,竽,窬,禺,盂,畬{新田二歲},璵,瑜,狳,牏,濡,漁{(又)},渝,毹{(又)},歟,歈,榆,旟,揄,挐{牽引},愚{(又)},愉{愉快，歡愉},庾{(又)},嵛,嵎,崳,孺,嬬,娛,妤{婕妤},如,嚅,喁{應和聲},儒,俞,余{我也；姓},伃{倢伃，同婕妤},于{(古)之子于歸；單于；姓；俗讀於是之於},予{我}
jyu5	jy24	㺄,齬,雨{風雨，雨水},鋙{鉏鋙},鄅,貐,語{(又)},與{贈與；參與，古讀去聲},羽,窳,禹,瘐,瑀,汝,敔{柷敔},擩{染；插},庾,嶼{(又)讀同與},峿{岨峿},宇,圉,圄,俁{俁俁},予{賦予},乳,与{同與字}
jyu6	jy22	喻,馭,預,雨{(古)動詞，下（雨、雪）},遇,豫,譽{榮譽},諭,語{(又)},裕,蕷,芋{芋頭；～蒙，芋葉莖},籲{呼籲},禦,癒{癒合},瘉,澦,洳,愈{愈加},悆,御,寓
jyun1	jyn53	㠾,鵷,鴛{鴛鴦，鴛侶},鳶,閼{閼氏},鄢,身{(古)身毒，印度的古譯名},蜎{蜎蜎},葾{敗也；〈語〉食物不鮮},菸{香菸，菸草},臙,胭,箢{箢箕},眢,燕{燕京、姓，俗讀燕子之燕},煙{煙霧，冒煙},焉{焉能，焉知},湮{(又)},淵,涴{地名，涴市（在湖北）},殷{殷紅},宛{古地名，大宛},嫣{嫣紅，嫣然},咽{咽喉},冤,㾓{骨節痠痛}
jyun2	jyn33	涴{涴演},菀{紫菀},苑,畹,琬
jyun3	jyn55	咽{吞咽},豔{(常)俗讀},諺{諺語，古諺},艷{(常)俗讀},燕{燕子；踢～子，踢毽子},灩{(又)},毽{(訓)訓讀燕，～子，毽子，踢～子，踢毽子},惌,怨,彥{俊彥，碩彥},宴,嬿,墕{地名用字；同堰字},堰,嚥{吞嚥},唁{弔唁，唁電}
jyun4	jyn21	䮄,黿,騵,鉛,鈆,轅,賢,袁,螈,蜒{蜿蜒，妯蜒},芫{(書)芫荽，芫花},芄,舷,羱,緣,綖,絃{琴絃},紈,筵,盷,痃,玹{玉色；石次玉；姓},玄,猿,爰,燃,然{然後，自然},焉{心不在焉，俗讀焉能之焉},烷,漹,源,湲,沿{沿途，沿海},沅,汍,櫞,椽{(又)讀同緣},杬,援{支援，援救},懸,弦{弓弦},延,完,嫄,媛{名媛，嬋媛},妧{人名用字},塬,埏{邊際},圜{天體；同圓字},圓,園{花園，園林},員{人員，員外},原,刓,元,伭,丸{肉丸}
jyun5	jyn24	泫,鉉,遠{遙遠；敬而遠之，古讀去聲},薳{植物嫩莖}
jyun6	jyn22	垸,願{願望，寧願},院,見{同現字},衒,衏,蜆{蝶類的幼蟲},縣{縣城，縣份},硯{硯臺，墨硯},眩{眩暈，目眩},瑗,琄,現,玹{玉名},烻{光熾},炫{炫耀，炫目},晛,昡,掾,愿,峴,媛{美女}
jyut2	jyt3	乙{甲乙},黦{黃黑色},釔,噦{乾嘔},咽{哽咽}
jyut5	jyt24	悅{喜悅，悅目},𡛟,閱,鉞,越,說{通悅字},粵,樾,曰
jyut6	jyt2	穴,茓
kaa1	kʰa53	㗇{(語)俗字，欺負，一說本字諕/謑/訶/呀/呼（上古魚部）},胩,揢{掐},掐{(訓)掐，～頸，本字揢},拤{掐，本字揢},喀{喀嚓},咖{咖啡},咔{象聲詞，～一聲；音譯用字，咔嘰，咔唑},卡{關卡；卡片，卡通},佧{佧佤族}
kaa3	kʰa55	㰤{張口息；大笑},髂,駕{駕駛，車駕},架{衣架，吵架；量詞，一架},旮{旮旯（角落、偏僻處）},假{放假，假日}
kaai1	kʰai53	揩{揩油}
kaai2	kʰai33	凱,闓,鎧,鍇,蒈,楷{(又)楷書},愷,塏,剴
kaai3	kʰai55	丐{(又)},鈣{鈣化，補鈣},炌,溉,概,摡{洗滌；主也},戤,慨{慷慨，感慨},愾,愒{貪也},嘅{同慨字}
kaak2	kʰak3	㸌{(又)},霍{(常)},觳{瘠薄},藿{(常)},臛{(又)},礐,碻,確{的確，確定},确,硞{石聲；堅固},矐{(又)},涸{乾涸，枯涸},榷{商榷},攉{(又)},擱{(白)擱腳，耽擱},搉{敲擊；通榷字},愨,恪,壑,埆,㺢{(又)}
kaak3	kʰak5	咯{同喀字，咯痰，咯血},喀{喀痰，喀血；瘦嚜[mak5]～，很瘦，與躿對轉}
kaam1	kʰam53	勘{勘探，勘誤},龕{神龕，佛龕},戡,嵌,嵁,堪
kaam2	kʰam33	坎{坎坷，心坎},砍{刀砍，砍伐},檻{門檻，又作門坎}
kaam3	kʰam55	瞰
kaang1	kʰaŋ53	㝩,𡐓,鱇,躿,漮,槺,康
kaang2	kʰaŋ33	慷{慷慨},鯁{(白)魚～，魚骨、魚刺}
kaang3	kʰaŋ55	亢{亢奮},閌{閌閬},鈧,砊{石聲},炕{火炕，炕頭},抗{反抗，抗戰，抗爭},囥{藏也},伉
kaang4	kʰaŋ21	扛{扛起，扛槍，源自抗，匣母讀如群母；馬螂～，螳螂}
kaat2	kʰat3	擖{刮；撻}
kaau1	kʰau53	尻
kaau2	kʰau33	拷{拷打，拷問},𥬯,考{考試，參考，壽考},烤{燒烤，烤火，本字燺},洘,栲,攷{敲擊；同考字，考核}
kaau3	kʰau55	㸆,鮳,靠,銬{手銬，鐐銬},翹{(語)閜[ko21]寥[lau55]～，彎彎曲曲},犒{犒勞},校{(又)學校}
kai1	kʰɐi53	傒{(白)傒倖},鼷{(白)},鸂,騱{(白)},蹊{(白)蹊蹺；蹊徑},豀{(白)},谿{勃谿，谿壑；姓},稽{稽查，滑稽},磎,溪,徯{(白)},嵇{(白)},奚{(白)奚落；姓}
kai2	kʰɐi33	䏿,綮{戟支；戟衣},稽{稽首},棨
kai3	kʰɐi55	契{契約，地契；～弟，本指義弟，今指孌童（因古代常以收義弟爲名收孌童）；老～公/婆，情夫/情婦},蟿,碶,瘈{瘈瘲}
kak2	kʰɐk3	克{一克，攻克，坦克},氪,可{(古)可汗},剋{剋扣，相剋，剋星},刻{時刻；用刀刻}
kak3	kʰɐk5	確{(白)犖[lɐk5]～，路不平或說話結巴，與硠砊對轉}
kam1	kʰɐm53	禁{弱不禁風；耐久，耐受},襟{襟懷，衣襟；老～，連襟},衿,衾
kam2	kʰɐm33	冚{蓋，本字𠖫，與扱/䆟對轉},𧾏{(白)（腰）略彎；～背，水蛇腰，指略彎的背部},𠖫{蓋，與䆟對轉，俗字冚},錦{(白)錦繡，織錦},扻{(白)摑},坅{坑}
kam4	kʰɐm21	坅{(語)坑，挖樹～，挖樹坑兒；～～扛[kʰaŋ21]扛[kʰaŋ21]，坑坑窪窪},蠄{(語)～螺[lo21]，蜘蛛，～蟝，蟾蜍}
kang1	kʰɐŋ53	坑,阬{同坑字},鏗{(白)鏗鏘}
kang2	kʰɐŋ33	啃{啃骨頭}
kang3	kʰɐŋ55	掯{強取也；〈語〉（菸、酒）勁大，（人）高傲，本字炕，乾也；半掕[lɐŋ55]～，半途、半路，本字硠砊},裉,砊{(白)半硠[lɐŋ55]～，半途、半路，與犖確對轉，俗字掕掯},炕{(白)（菸、酒）勁大，～喉，嗆喉；（人）高傲，～陡，目中無人，～橛[kʰɛt5]橛[kʰɛt5]，高傲，俗字掯}
kap2	kʰɐp3	㴔,給{供給，給予},級{級別，年級；臺階兒，碼頭～、石～，石階},笈{祕笈},熻,汲,歙{同吸字},扱{收斂；〈語〉蓋，本字䆟，與冚/𠖫對轉},噏{同吸字；收斂},吸,伋,䆟{(白)蓋，與𠖫對轉，俗字扱}
kap3	kʰɐp5	䆟{(白)～斗，倒閉；～𩪤[ŋɐp3]，（女孩）怕羞}
kat2	kʰɐt3	咳{咳嗽},欬{咳嗽}
kat3	kʰɐt5	橛{(白)量詞，截}
kau1	kʰɐu53	彄,芤,瞘{眼瞘},摳{挖，～牆壁；擡起、端起，～張凳過來}
kau3	kʰɐu55	䍍{未燒瓦器},鷇,釦{金飾；同扣字，紐扣},購{(又)},覯{(又)},蔻,筘,構{(又)},构{(又)},搆{(又)},扣{扣住，折扣，紐扣},怐,寇,媾{(又)},叩{叩頭},佝{佝瞀}
ke1	kʰe53	𡲢
ke3	kʰe55	㹃{(訓)撥開東西找，或源自撬/擓}
ken5	kʰɛn24	䗃{(白)蛾～，螻蛄、土狗}
ket3	kʰɛt5	橛{(白)量詞，截}
keu3	kʰɛu55	撬{亂翻、翻找，疑本字趬},翹{(語)乾～～，乾貌；閜[ko21]寥[lɛu55]～，彎彎曲曲}
keu4	kʰɛu21	翹{(語)硬～～，乾而硬}
ki1	kʰi53	崎{崎嶇},踦{腳跛},觭{角一俯一仰},畸,欹{同攲字，傾斜},攲{傾斜}
ki2	kʰi33	企{企業，企求},跂{踮起腳跟},婍{貌好}
ki3	kʰi55	亟{亟請},碶{(又)},契{(又)契約，地契，又讀[hi55]；～崽，義子},唭{無聞見；有聲無辭}
kiak2	kʰiɐk3	卻,覺{感覺，覺得，知覺，覺悟},緙{緙絲}
kiang1	kʰiɐŋ53	僵{凍僵},韁{同繮字},蜣,腔{口腔，腔調，幫腔，讀同羌},羌{羌族，羌笛；姓},繮{繮繩，脫繮},疆{新疆，邊疆，疆域},殭{殭屍},彊{同疆字},勥{(白)欺負，～人，欺負人}
kiang2	kʰiɐŋ33	勥{迫也},鏹{鏹水，白鏹},襁{襁褓},膙,羥{羥基},繈,彊{同強字},強{勉強；倔強},弶
kiang3	kʰiɐŋ55	躿{(語)瘦蜢[miɐŋ55]～，瘦貌，與喀對轉}
kik2	kʰek3	擊{攻擊},𠽤
king1	kʰeŋ53	傾{傾盡，傾斜，傾向；〈語〉聊，～大聲，吹牛}
king2	kʰeŋ33	廎,頃{頃刻，公頃},苘{同檾字，苘麻},檾{檾麻}
king4	kʰeŋ21	煢
kit2	kʰit3	劼,頡,詰{詰問},訐,襭,蛣{蛣蜣},羯,纈{採纈},竭{竭力，枯竭},碣,擷,揭{揭開，與掀或搴對轉},孑
kiu2	kʰiu33	巧{(白)巧妙，技巧；啱巧（湊巧），偷巧（取巧），七巧（猜碼口令，數字七）},蹺{蹊蹺，高蹺（口語稱高腳排/師）}
kiu3	kʰiu55	竅{出竅，竅門，訣竅}
ko1	kʰo53	坷{坷垃},𪽇,鈳{鈮的舊譯},軻,蝌{蝌蚪},苛,窠{窠巢，窠臼},稞,砢{砢磣；同珂字},珂,牁,樖{樹枝交連},棵{一棵},柯
ko2	kʰo33	可{可以},顆{一顆，顆粒},閜{閜砢},舸{(又)},炣,岢,坷{坎坷},哿{(又)}
ko3	kʰo55	課{上課，課文},騍
ko4	kʰo21	㰤{(語)打～羅，打呼嚕}
koek2	kʰœk3	曲{曲折；歌曲；姓},𪨰,麴{酒麴（口語稱酒餅）；姓},麯{同麴字},酷{殘酷，酷熱},蛐,硞{碌硞},焅
koeng2	kʰœŋ33	孔{孔雀，鑽孔；姓},恐{恐怕，恐龍}
koeng3	kʰœŋ55	控{控制，失控}
kon2	kʰon33	款{(又)},窾{(又)}
ku1	kʰu53	圐,骷{骷髏},箍
kui1	kʰui53	櫆,魁,盔{頭盔，盔甲}
kui2	kʰui33	傀{傀儡},磈
kuk2	kʰok3	㸌,霍{霍亂，揮霍；姓},钁{大鋤},郭,蠼{母猴},藿{藿香},臛,矐,矍{矍鑠},玃,漷,槨,曤,攫,攉,擴{擴充，擴大},彍{同彉字},彉{張也},廓{輪廓，廓清},崞,劐{裂也},㺢
kuk3	kʰok5	嗑{(語)～瓜子，本字硞},硞{(語)～瓜子，嗑瓜子}
kung3	kʰoŋ55	壙,鄺,纊{絲綿絮},爌,曠{空曠，曠野}
kwaa1	kʷʰa53	侉{疲憊；同夸字},骻{同胯字},跨{跨越，跨過，讀同夸},誇{誇獎，浮誇},胯{胯部，胯骨，讀同跨/夸},姱,夸{奢侈；夸父；夸克},垮{垮臺，打垮}
kwaa2	kʷʰa33	侉{粗笨；口音不正},𠜴{(語)割，～草},垮{(又)打垮}
kwaa3	kʷʰa55	挎{挎包}
kwaa4	kʷʰa21	呱{(語)象聲詞，～～聲}
kwaai2	kʷʰai33	拐{(又)拐棍},蒯{蒯草；姓},柺{(又)},枴{(又)}
kwaai3	kʷʰai55	快{(文)愉快，快樂},筷{(常)筷子，碗筷}
kwaak2	kʷʰak3	廓{(白)名詞，框、圈，與框或纊對轉，上古鐸部，俗字𡃈},𡃈{(名)俗字，框、圈，與框或纊對轉，本字廓，上古鐸部}
kwaak3	kʷʰak5	搉{(白)敲，特指屈指用手指節敲擊，～一鑿，打一下}
kwaang1	kʷʰaŋ53	㑌,誆,筐,眶{眼眶},洭,框{門框，框住},哐{象聲詞},匡,劻
kwaang2	kʷʰaŋ33	摜{(語)扔、丟，疑本字逛，走貌},梗{(白)菜梗，豆梗}
kwaang3	kʷʰaŋ55	㝩{(白)空～㝗，空蕩蕩},貺,穬,礦,獷{(又)讀同礦/曠},況,曠{(常)},夼,壙{(又)}
kwai1	kʷʰɐi53	噅,麾,鬹,隳,闚{同窺字},輝{光輝，輝煌},規,褘,虧,翬,窺,琿{璦琿},煇,暉,撝,揮{揮手，指揮；～春，春聯},徽,巋,巂{子巂},嶲{同巂字}
kwai2	kʷʰɐi33	煃,頍,跬
kwai3	kʷʰɐi55	䙡,鱠,闠,鄶,膾{膾炙人口},聵,硊{石硊},獪{狡獪},澮,潰{潰爛，崩潰},殨,檜{喬木名；秦檜},憒,愧,嘳,劊{劊子手},儈
kwak2	kʷʰɐk3	廓{(白)動詞，擠，～痱子；勒緊，～頸，上古鐸部，俗字𡃈},𡃈{(動)俗字，擠，～痱子；勒緊，～頸，本字廓，上古鐸部}
kwak3	kʷʰɐk5	鐝{(白)鐝頭},钁{(白)钁頭}
kwan1	kʷʰɐn53	囷,鵾{(白)},鯤,髡,錕,鋆{人名用字},鈞{千鈞，鈞鑒},醌,筠{地名，筠連（在四川）},琨,焜,昆{昆蟲，昆明},崑{崑崙山},婫{人名用字},堃,坤,均{平均，均勻}
kwan2	kʷʰɐn33	壼,鯀{(又)},閫,緄{(白)緄邊},綑{織也；同捆字},混{(白)相混，混合，混亂},捆{捆綁},捃{拾也},悃
kwan3	kʷʰɐn55	困{困難，圍困},睏{(文)}
kwang1	kʷʰɐŋ53	揈{擊聲；驅趕},轟{轟炸，轟動},輷,訇{象聲詞；阿訇},硡{石落聲}
kwang3	kʷʰɐŋ55	纊{(語)掛着、絆着，與𡃈/廓對轉}
kwat2	kʷʰɐt3	㧾{(又)（牛等）兩角左右擺動擊打或挑，渠捱牛～一角},鍃{(又)},笏{(又)},淴{(又)},曶{(又)},昒{(又)},惚{(又)},忽{(又)},囫{(又)},唿{(又)},㺀{(又)}
kwe2	kʷʰe33	蛙{(白)～子，小青蛙，上古支部，俗字𧊅},𧊅{(白)～子，小青蛙，本字蛙，上古支部}
kwe3	kʷʰe55	㨤{(白)},擓{(白)撥拉}
kwik2	kʷʰek3	掝{破裂聲},隙{縫隙，空隙，讀如合口},郤{古地名；通隙字；姓},郄
kyu1	kʰy53	㘗,鮈,驅,軀,跔,袪,胠,祛,痀,泃{水名},拘{拘留，拘束},嶇{崎嶇},區{區域},俱{(又)本讀},佝{同拘字},佉,㭕
kyut2	kʰyt3	㵐,黠{(又)讀同詰},鴃,鴂,駃{駃騠},闕{宮闕；失也},闋,鐝{農具},鐍,鍥{鍥而不捨},蹶{一蹶不振，尥蹶子},譎,訣,觖,蠍{(白)蠍子，蛇蠍},蝎{(白)同蠍字},蕨{蕨菜},缺{缺乏，短缺},絜{度量},砄,璚{同玦字},玦,獗,炔{乙炔},決,橛{木橛，又作橜字},撅{翹起；折斷},挈{提綱挈領，帶挈},抉,憠{脾氣憠},孓,契{契闊；契丹},噘{噘嘴},厥,劂
la2	lɐ33	嘞{(語)語氣詞，弱讀}
laa1	la53	剌{割開；音譯用字；〈語〉～喉，（臘製的肉放久後）對喉嚨有刺激，～油，（臘製的肉放久後）有油臭味},𤰚,鞡,拉{卡拉OK；坷拉，同坷垃/𪽇𤰚；同剌字},垃{坷垃，又作坷拉/𪽇𤰚},喇{象聲詞},啦{助詞；啦啦隊；大～～，大大咧咧}
laa2	la33	喇{喇叭；喇嘛；語氣詞，且爲已然體標記（了2），花開～，弱讀爲嘞[lɐ33/lə33]或啊[∅a33/∅ə33]},嘞{語氣詞，同喇字}
laa3	la55	㱻{(白)發～，發瘟},罅{(訓)縫隙，與旯同源，旮旯源自角落},旯{旮[kʰa55]旯（角落、偏僻處）；旮[ka55]～頭，苤藍或苤藍的莖},喇{象聲詞，嘟[tu55]嚕[lu55]咑[ta55]～，東西掉落聲，喳[tʃa55]～蟲，蟬}
laa4	la21	啦{(語)象聲詞，啤[pi21]哩[li21]叭[pa21]～，鞭炮聲、雨聲},籮{(白)籮斗}
laa5	la24	揦{俗字，聚斂、挽起，疑本字擄},藞{藞䕢}
laai1	lai53	孻{粵字，排行最小的，一說本字落/攋，本地稱細或晚，～崽},拉{拉扯，拖拉}
laai2	lai33	𦧺{俗字，舔，一說舐字音變，本地不用}
laai3	lai55	癩{癩瘡，癩蛤蟆；～鬍子，絡腮鬍},賴{(又)～臭，耍賴，後字調類化}
laai4	lai21	䧒,鶆,錸,萊,淶,棶,徠{招徠},崍,嚟{粵字，來，本字來},倈{古族名；元雜劇俗稱小孩，倈兒；地名用字},來{未來，來回，過來}
laai5	lai24	攋{(白)～尿，遺尿，俗字瀨/落},襰{襰𧜁，衣破貌；〈語〉落[lak2]～，衣着不整，捋[lot5]捋[lot5]～～，褲子下滑貌}
laai6	lai22	唻,賴{依賴，賴帳；姓；～臭，耍賴},賚,誺{誤},籟,睞,瀨{急瀨，湍瀨},攋{毁裂；棄去},徠{勞徠}
laak2	lak3	咯{吡咯},駱{駱駝；姓},餎{餄餎},雒,鉻{剃髮},酪{奶酪},絡,珞,犖{卓犖，犖確},烙{烙印，炮烙},漯{漯河市，本作螺},洛
laak3	lak5	嘞{俗字，（衣服）裂開，本字阞；～咑[tak5]，不整潔，本字肋脦},阞{(白)（衣服）裂開，俗字嘞},落{(白)歷[lek5]～，利落},肋{(語)～脦[tak5]，不整潔，俗字嘞咑},挌{(白)打；擊}
laak5	lak24	樂{快樂；音樂},躒{卓躒},落{落雨，下落，落車（下車），落船（上船）；～利，利落穩當},硌{山上大石},濼{水名，濼水（在山東）}
laak6	lak2	落{(語)～襰[lai24]，衣着不整}
laam4	lam21	婪,𨅏,襤,藍,籃{菜籃，籃球},嵐
laam5	lam24	擥,𥗽,覽,艦,罱,灠{灠柿子},漤{漤柿子},欖{(文)},攬{攬住；包攬，與拉/擸對轉}
laam6	lam22	檻{欄杆；獸欄},纜,灠{同濫字},濫{氾濫，濫用}
laan1	lan53	蘭{(白)荷蘭，蘭豆（豌豆）；〈外〉女友或男友的俗稱，原讀法蘭，英語friend},躝{(白)爬行；滾開}
laan4	lan21	攔,闌,鑭,躝{(文)踰也},讕,襴,蘭{蘭花，玉蘭},瀾,欄{圍欄，豬欄，牛欄},暕{陰乾},斕
laan5	lan24	嬾,懶
laan6	lan22	濫{(常)俗讀，嗜、好，～賭，～哭，～飲，～睡，俗字爛},爛
laang1	laŋ53	唥{擬鈴聲；〈語〉同𦀬字，毛線，～衫},𦀬{俗字，毛線，～衫，又作唥字，或與羊同源，上古陽部，另一說法語laine/葡語lã/英語woollen},啷{噹啷}
laang3	laŋ55	㝗{(白)空㝩～，空蕩蕩},𢲲,浪{(白)東遊西逛},朗{(白)稀～～，稀疏貌、（粥）很稀；疏～～，稀疏貌}
laang4	laŋ21	㝗,閬{閌閬},鎯,鋃,郎,螂{蟑螂，螳螂（口語稱馬螂扛）},蜋{同螂字},筤,稂,硠{石聲},瑯,琅{琳琅，琅琊},狼,榔{檳榔，桄榔},桹,廊,嫏
laang5	laŋ24	㙟{江、湖邊的低窪地；地名用字},𠺘{俗字，漱、涮洗，或源自盪},誏{同朗字},蓢,盪{(語)漱、涮洗，或爲來回盪的合音，另一說本字盪，上古陽部，俗字𠺘/𠻴},烺,朗{明朗，朗讀，疏朗},悢{懭悢},崀,塱{同㙟字},埌{地名，埌東、埌西，與㙟/塱同源},㮾
laang6	laŋ22	㫰{晾曬，俗字晾},閬{閬苑，閬中},誏{戲言},蒗,莨{莨菪},浪{風浪，浪費},晾{曬，本字㫰},埌{墳墓}
laap2	lap3	䁽{(語)俗字，掃視，與覽對轉，本字拉},擸{(語)俗字，聚斂、蒐集，與攬對轉，本字拉},拉{(白)聚斂、蒐集，與攬對轉，俗字擸；掃視，與覽對轉，俗字䁽}
laap5	lap24	垃{垃圾，本字擸𢶍},鱲{腌魚},鑞{錫鑞},蠟,蜡{同蠟字},臘{臘月，臘肉},腊{同臘字},擸{折、碾；擸𢶍，又作垃圾/拉颯},搚,拉{拉雜，拉颯（垃圾）}
laat2	lat3	蝲{(語)一種花毛蟲}
laat3	lat5	𤊶{(白)熱、燙，～水、～手}
laat5	lat24	剌{乖剌，剌謬},𤊶{火貌},鯻,鬎{鬎鬁，同瘌痢},邋{邋遢},辣{辣椒，辛辣，老辣},蝲{蝲蛄，蝲蝲蛄},癩{癩痢，同瘌痢},瘌{瘌痢},喇{哈喇}
laat6	lat2	剌{(語)白～擦[tʃʰat2]，蒼白，元曲寫法}
laau1	lau53	撈{攪拌，乾～，乾拌；摻和，～亂；賺，～錢，賺錢}
laau3	lau55	嫪{(白)姣姣～～，淫蕩，打～，發情},寥{(白)又音，稀～～，疏～～；閜[ko21]～翹[kʰau55]，彎彎曲曲}
laau4	lau21	㗦{～嘈，吵鬧，又作嘮嘈},𡑍,髝{急貌；高貌},鐒,醪,蟧,簩,癆{癆病，肺癆},牢,撈{打撈，撈魚；～籬[li21]，笊籬},嶗,嘮{嘮叨，嘮嘈（同㗦嘈）},勞{勞動；慰勞，古讀去聲}
laau5	lau24	䇭,銠,荖,老{老人，老師；～孃[niɐŋ53]、～子，母親、父親的敘稱},獠{蠻族},潦{(古)雨大貌},橑,栳,摎{(語)～攪[kau22]，胡搞、搗蛋，當是亂攪鬧之音變},姥{姥姥},佬{俗稱男子，本字老}
laau6	lau22	嫪{嫪毐},耮,澇{澇災，旱澇；〈語〉溢出，溣[lɐn22]溣[lɐn22]～～，田水滿溢}
lai2	lɐi33	𣛒{(白)瞟、斜着眼睛看，～一眼渠就行喇，又作𥉆字},𥉆{(白)瞟、斜着眼睛看}
lai3	lɐi55	䚕{(白)找，～書、～醫生},𧢝{(白)同䚕字，找}
lai4	lɐi21	㰀,黧,黎,藜,蔾,犂{同犁字},犁,嚟{譯音用字}
lai5	lɐi24	劙{刀刺；〈語〉用腳掌擦地前進以翻動曬場的穀物},鱧,醴,豊,蠡,禮,澧,戾{(白)扭轉，～着腳，崴腳}
lai6	lɐi22	䚕{求視},𧢝{視也},𥉆{同𣛒字},𣛒{竊視也},麗{美麗，麗質},迣{(又)},蠣,荔{荔枝},綟{青綠色},糲,礪,癘,珕,沴{沴孽},欐,攦,捩{琵琶撥法},厲{嚴厲，厲行},勵,儷,例
lak2	lɐk3	落{(又)落來（下來），落車（下車），落船（上船）}
lak3	lɐk5	嘞{(語)詞綴，跳～～，（人、動物）跳動貌，疑本字躒},犖{(白)～確[kʰɐk5]，路不平或說話結巴，與硠砊對轉},烙{(白)熱}
lak5	lɐk24	仂{餘數},鰳,阞{地的脈理；裂開},艻,肋{肋骨，兩肋；～索[ʃiɐk3]骨，（人或高等動物的）肋骨},簕{簕竹，簕欓；〈語〉植物的刺或魚刺，本字竻},竻{竹根；〈語〉植物的刺或魚刺，俗字簕},玏,泐,朸{(又)},扐,叻{石叻，叻埠，呵叻},勒{勒索；勒緊}
lam1	lɐm53	冧{哄，～鷄捉狗，比喻語無倫次，本字或爲啉，聒也},啉{哄，～鷄捉狗，比喻語無倫次，俗字冧}
lam2	lɐm33	𨅏{(白)～水，蹚水、涉水}
lam3	lɐm55	冧{垮塌，塌陷，～本，折本，或與陷/窞同源，上古談部，另一說淋的引申}
lam4	lɐm21	啉{喹啉},霖,臨,箖,痳{同淋字，淋症},琳,淋{淋雨；淋鹽},林
lam5	lɐm24	㨆{殺也打也},稟{同廩字},檁,懍,廩{倉廩，廩食},壈,凜
lam6	lɐm22	㨆{(語)摞、碼、堆叠，～磚，本字廩，與拉對轉},廩{(語)摞、碼、堆叠，～磚，俗字㨆，與拉對轉}
lan1	lɐn53	㖮{緊、結實，或源自耣/稐}
lan2	lɐn33	溣{(語)弄髒、沾染，亞隻饅頭～着泥喇},𡳞
lan3	lɐn55	碖{(白)掉落，屋燂灰～落歸喇，與㪐[lɐt5]對轉}
lan4	lɐn21	侖{加侖},麟,鱗,驎,鏻,錀{金},鄰,遴{遴選},轔,輪,論{論語，俗讀議論之論},膦{膦軟},翷,繗,綸{滿腹經綸},粼,磷{白磷，磷礦，磷肥},瞵{注視},璘,燐{燐火},潾,淪{淪爲，沉淪},掄,嶙,崙{崑崙山},埨,圇,倫
lan5	lɐn24	屯{(語)溢出，～出，溢出；案，邢公畹《漢台語比較手冊》認爲民族語對音與『屯』可比較，滿也、盈也，上古文部，另一說爲𢅯，民國26年《邕寧縣誌》第四冊，器物滿盈曰𢅯},碖{石落貌}
lan6	lɐn22	吝{吝嗇},遴{行難也；通吝字；～盡，不利索、麻煩},躪,論{議論，論文；～日，成天},藺,膦{有機化合物},碖{石貌；大小勻貌},溣{水中曳船；〈語〉～～澇澇，田水滿溢}
lang1	lɐŋ53	㘄{象聲詞},揚{(語)〈名、動〉篩，～箕，籮篩，～穀，簸穀，與揚同源，上古陽部}
lang3	lɐŋ55	掕{(語)半～掯，半途、半路，本字硠砊},稜{(語)鞭痕},硠{(白)半～砊[kʰɐŋ55]，半途、半路，與犖確對轉，俗字掕掯},棱{(語)鞭痕},朗{(白)又音，稀～～，疏～～}
lang4	lɐŋ21	倰{長貌；〈語〉鬅[pɐŋ21]鬙[ɬɐŋ21]～，不整潔},楞{發楞；地名，楞塘村},掕{(白)攔截，與勒對轉},愣{發愣，同發楞},塄,啷{(語)象聲詞，呯呤[leŋ21]嘭[pɐŋ21]～，劈哩啪啦}
lang6	lɐŋ22	唥{冚唪～，全部；冚唪唥也是猜碼口令，數字十，也說開清手、全開手}
lap2	lɐp3	拉{(白)套、戴，～高帽，戴高帽，俗字笠},笠{(白)竹～，竹簍；執～，不給錢將貨物拿走；借字，～衫、～頭衫，套頭衫，本字拉}
lap3	lɐp5	泣{哭泣},笠{(白)又音，竹～，竹簍}
lap5	lɐp24	砬{石藥；砬子},鉝,笠{斗笠，蓑笠},立{立正，建立；～亂，凌亂、隨便，一說本字𦆻}
lat2	lɐt3	捋{(白)摘取，～辣椒，俗字揦},揦{俗字，摘取，～辣椒，本字捋}
lat3	lɐt5	㪐{(白)脫落、掉，與碖[lɐn55]對轉，俗字甩},甩{(訓)脫落、掉，訓讀㪐，與碖[lɐn55]對轉}
lat5	lɐt24	㖀,𤝽,葎,聿{(又)},篥,硉,率{效率},溧,栗,慄,律{律師，法律},垏,凓,傈,㪐{不穩},㗚{嘍㗚}
lau1	lɐu53	嘍{助詞},褸{大衣；口水～，涎布、圍嘴兒},蔞{(白)假～，假蒟、假蔞葉，與蔞葉（也叫蒟醬）形似但不同種},瞜{視也},摟{邀請；挑逗；（蒼蠅等）趴；披，～件衫；搜刮，～錢}
lau3	lɐu55	漏{(白)撿漏、在農地翻找，～花生、～番薯；遺漏物},騮{(語)又音，馬[ma55]～，猴子}
lau4	lɐu21	僂{佝僂，僂儸},鶹,髏{骷髏},騮{驊騮；〈語〉馬[ma24]～，猴子，又作馬留/馬流/獁騮/馬𧳽/馬𤠑，一說源自沐猱},餾,飀,鏐,鎦{鎦金},鎏,遛{逗遛},螻,蔞{蔞蒿，䒷蔞},膢,耬{耬車},窶{甌窶},硫{硫磺},瞜{(又)},瘤,疁,留,瑬,琉{琉璃},瀏,漻{變化貌},漊{水名，漊水},流{流水，河流；～嘢，劣質貨；新年～～，大過年的},樓,榴{石榴，榴槤},旒,摎{姓},婁,嘍{嘍囉},劉,剅
lau5	lɐu24	塿{培塿（小土丘）},鋶,罶,縷{(訓)訓讀綹},綹,簍,珋,漊{水溝},柳,摟{摟抱},嶁
lau6	lɐu22	塿{(語)～培[pɐu22]，不整潔、臃腫，古作培塿/部婁，俗字瘻婄/漏䏽},鷚,霤,陋{簡陋},鏤,鎦{鎦子},遛{遛彎，遛狗，遛達},蹓{同遛字，蹓躂，蹓狗},瘻{瘻管，痔瘻},瘺,熘,漏{漏雨，漏洞；～口，走漏祕密；～風，因牙齒脫落說話攏不住氣},溜{水溜，急溜}
le2	le33	咧{(語)嗲[te33]嗲[te33]～～，撒嬌的聲音或態度}
le3	le55	咧{大大咧咧（口語稱大啦啦）；唓[tʃʰe55]～，話多、愛表現，源自啁嘐/嘐啁，語多},哩{語氣詞}
le4	le21	咧{(語)語氣詞，𠯔斜[tsʰe21]～，呸；象聲詞，唏[hi21]哩[li21]㗾[he21]～，喘氣聲，啤[pi21]哩[li21]嘣[pɛm21]～，鞭炮聲},罟{(語)〈名〉魚網；〈動〉～魚，網魚；案，民族語對音爲[r-/x-]，與漢語[k-/kʰ-]有對應},旯{(語)旮[ke22]～子，縫}
le5	le24	攋{(白)～出來，潑或流出來},褦{(習)褦襶（衣着不整；吊兒郎當），或與襰𧜁同源}
lem4	lɛm21	䭑{(語)𩛌[tse22]～，小孩嘴饞}
lem5	lɛm24	舐{(語)舔},舔{(語)舔，～碗，又作舐字}
len1	lɛn53	瞵{(白)砂子等進入眼睛的感覺，眼～}
len3	lɛn55	摙{(白)遞，～許我}
lep2	lɛp3	甲{(語)穀～，穀殼，與甲同源，上古葉部}
lep6	lɛp2	笠{(語)鴨～，竹製以圈鴨的圍簾，又稱竹圍}
let3	lɛt5	𤊶{(白)又音，熱、燙}
let6	lɛt2	剌{(語)用刀劃，～開去、～一刀}
leu1	lɛu53	嫽{(白)挑逗、撩撥，冇～人哋打交},溜{(白)灰～～，灰暗貌，又喻事情做得不好},撩{(白)～耳朵，掏耳朵；～起，掀起；～火棍，撥火棒}
leu2	lɛu33	鷯{鷯哥[ko33]（形似八哥兒）}
leu3	lɛu55	嘐{(白)啁[tʃɛu55]～，嘴巴厲害},𣩢{(白)枯萎},蔫{(訓)枯萎，本字𣩢},料{(白)打漂[pʰɛu55]～子，打水漂兒},寥{(白)空～～，空蕩蕩；～鬍子，稀疏的鬍子；疏～～，稀疏貌；閜[ko21]～翹[kʰɛu55]，彎彎曲曲}
leu4	lɛu21	獠{(白)獠牙}
li1	li53	哩{嘰哩咕嚕；花～花碌，花裏胡哨},喱{咖喱，啫喱}
li4	li21	剺{剝也},麗{麗水，高麗，俗讀美麗之麗},鸝,鱺,驪,離{離別，距離},釐{釐定，毫釐},醨,貍{貍貓，狐貍},蜊,蘺,罹,纚{綝纚},縭,籬{籬笆，籬下},篱{同籬字},离{同離字},璃{玻璃；琉璃},琍,狸{同貍字，狸貓，狐狸},犛,灕{灕江},漦{涎沫也},漓{淋漓盡致},梩,梨,杝{同籬字},嫠,哩{(語)象聲詞，唏[hi21]～㗾[he21]咧[le21]，喘氣聲，啤[pi21]～嘣[pɛm21]咧[le21]，鞭炮聲，啤[pi21]～叭[pa21]啦[la21]，鞭炮聲、雨聲},厘{厘米，同釐米},劙{(又)}
li5	li24	俚,鯉,鋰,里{千里，里程，里弄；〈語〉帆，避諱翻，轉讀里，音近利，看風駛～，見風駛舵，俗字𢃇},邐,裡{同裏字},裏{裏外；衣裏},理,浬,李,悝{憂傷},峛,履{(書)},娌,哩{英里的舊稱}
li6	li22	俐,鬁{鬎鬁，同瘌痢},詈,蒞{同莅字},莉,莅{莅臨，莅會},脷{舌頭，本字利，避諱舌/折},痢{痢疾（口語稱屙痢）；瘌痢},猁,浰{(又)},唎,吏,厲{(語)厲害，本字利害},利{順利，利益；舌頭，俗字脷，避諱舌/折；～市[ʃi22]，紅包}
liak2	liɐk3	擽{(白)撇開、撇去，～開啲粥泡去},略{(又)大略}
liak3	liɐk5	叻{俗字，能幹，與靈對轉，本字力，其餘諸說，𥌮/𦘊/嚦/㔹，皆非也}
liak5	liɐk24	䂮,砳,略{戰略，大略},擽{擊也},撂{掠取，本字㨼},掠{擄掠，掠奪},圙
liang3	liɐŋ55	靚{(訓)漂亮，本字令}
liang4	liɐŋ21	俍,量{測量},輬,踉{跳踉},莨{薯莨},良,綡,糧,粱,粮,涼{冰涼，涼爽},樑{房樑，脊樑},椋,梁{梁山，梁朝；姓},墚
liang5	liɐŋ24	䓣,魎,輛{車輛},裲,蜽,緉,啢,冷,兩{兩個，兩斤；斤兩，二兩；～人好，猜碼口令，數字二},倆
liang6	liɐŋ22	亮,量{數量},踉{踉蹌},諒,惊{同悢字},悢{惆悵},喨,倞{求；索取}
lik3	lek5	歷{(白)～落[lak5]，利落}
lik5	lek24	㠣,鬲{古代炊具},靂,鎘{同鬲字},酈{姓},轢,躒{動也},藶,秝,礫,癧{淋巴結},瓅,瀝{瀝青，瀝血},濼{蕨科植物},歷{歷史，經歷},櫪,櫟{木名},朸,曆{日曆},擽{捎也},壢,嚦{嚦嚦},厤,力{力量，有力},仂{同力字}
lim4	lim21	奩,鬑,鐮{鐮刀，火鐮},鎌,蠊,薕,臁,聯{(又)},簾{窗簾，簾幕},磏{礪石},燫{同熑字},熑{火不絕},濂,廉,帘{酒帘}
lim5	lim24	䭑{小食也},襝,蘞{白蘞、赤蘞},薟{白薟},臉{臉頰；臉面},殮{裝殮，入殮},斂{收斂}
lim6	lim22	瀲
lin3	lin55	摙{(白)打滾；～地，滾地；～～趢[lœk3]趢[lœk3]，滾來滾去，俗字碾/輾}
lin4	lin21	怜,鰱{鰱魚},連,褳,蓮{蓮花，蓮子},聯{聯合，對聯，肉聯廠},漣,槤{榴槤，槤枷},憐
lin5	lin24	僆{小雞；孿生},鄻,璉{瑚璉},摙{擔；運}
lin6	lin22	戀{戀愛，留戀},𥽸,鰊,鏈{拉鏈，鏈條},鍊{鍊金；鍊條，後作鏈},練,瑓,煉{冶煉，煉油},浰,楝{苦楝，楝樹},摙{按}
ling1	leŋ53	令{量詞，一令紙},靈{(白)精～，機靈，實爲精的分音},拎{(書)}
ling3	leŋ55	坽{(語)傾斜、陡；坡道，本字或爲嶺，阪也},鈴{(白)一種遊戲用具，鐵製圈；～啷[loŋ33]，搖鈴聲；～啷[loŋ33]佬，貨郎；車～，單車鋼圈}
ling4	leŋ21	〇,齡,鴒,鯪{鯪魚，鯪鯉},靈{靈活，神靈},零{零分，孤零零，九點零鐘（九點多鐘）},陵,鈴{風鈴，鈴鐺},醽,酃,踜{跌倒},蛉,薐,蔆,菱{菱角},苓,舲,聆,翎,羚,綾,笭{笭箵（口語稱魚䉴）},稜{同棱字},祾,睖,瓴,玲,爧,澪,淩{水名},泠,欞,櫺,楞{楞伽，楞嚴；同棱字},棱{棱角，棱柱，模棱兩可},柃,昤,掕{止也},崚,岭{岭巆},姈,堎,坽{峻岸},囹,呤{呤呤；象聲詞，呯～嘭[pɐŋ21]啷[lɐŋ21]，劈哩啪啦},凌{冰凌，凌厲},倰{欺凌},伶{名伶，伶俐，孤伶伶},令{令狐，俗讀命令之令},㥄
ling5	leŋ24	岭{同嶺字},領{領獎，衣領},嶺{山嶺，嶺南；地名，長堽嶺，石柱嶺}
ling6	leŋ22	令{令人，命令},踜{踜蹬},炩{炩火},呤{嘌呤},另{另類，另外}
lip5	lip24	䁽{目暗},鱲{鱲魚，又稱桃花魚},鬣,躐,獵{打獵，獵人},擸{理鬚髮}
liu1	liu53	撂{放下},蹓{同溜字，蹓走},熘{(又)},溜{溜走，溜冰，順口溜；稀～～，稀疏貌、（粥）很稀}
liu2	liu33	镽{(語)樹標～，樹梢}
liu4	liu21	僚{官僚，同僚},鷯{鷦鷯},髎,镽{細長},鐐,遼,蹽,聊,繚{繚繞，繚亂},簝,瞭{瞭望},療,獠{獠牙},燎{燎原；火燎，古讀上聲或去聲},潦{潦草；潦倒，古讀郎刀切},漻{水清貌},橑{(又)},敹,撩{撩動，撩撥},憭{憭慄},寮{茅寮，寮舍},寥{寂寥，寥廓},嫽{戲弄},嘹
liu5	liu24	了{了結，不得了；助詞，完成體標記（了1）},镽{長貌},釕{金屬元素，符號Ru},蓼{辣蓼（水蓼）},瞭{瞭解，明瞭},憭{聰慧}
liu6	liu22	尥{尥蹶子},𪤗,𣩢{敗也},釕{釕銱兒},炓,料{預料，材料，調料},廖{姓}
lo1	lo53	囉{囉唆}
lo2	lo33	倮,裸{裸體},蠃{蜾蠃},蓏,臝,砢{磊砢},瘰{瘰癧},攞{拿、取、要，源自攎，持也，本地用取或要}
lo3	lo55	咯{語氣詞},螺{(白)捹～～，團團轉，圝陀[to55]～，形容很圓}
lo4	lo21	㼈,騾,饠,鑼,邏{邏輯，巡邏；〈語〉簸[po21]梭[ɬo21]～，樹冠覆蓋面大，遮陽好},螺{(又)},蘿{蘿蔔，藤蘿},羅,籮{名詞，～頭，籮筐；量詞},玀{豬玀},欏,囉{嘍囉，囉唕},儸{僂儸}
lo6	lo22	㱻,摞{摞起來}
loe1	lœ53	𦧲{吐，本爲象聲詞，擬吐聲}
loe2	lœ33	𦧲{揩擦，疑本字縷/捋/擼}
loek2	lœk3	簏{(又)},轆{(白)碾、軋、滾，牛～湴，牛滾爛泥},趢{(白)仆[pʰœk3]仆[pʰœk3]～～，踉踉蹌蹌}
loek5	lœk24	㟤{兩山間低凹狹窄之地；地名用字},麓{山麓，麓林},鹿,騄,陸,錄,醁,逯,轆{軲轆},趢{趢趗，趢𧼙},谷{(古)谷蠡王},蓼{草長大貌},菉,綠,籙,簏,稑{疾熟也},祿,磟{磟碡},碌{忙碌，勞碌；碌碡；礦物名，石綠},睩{視貌},盝,甪,琭,熝{煉也；〈語〉燙},漉,淥,氯,樚,摝{振、搖},戮,彔,坴,勠,六{第六，六藝；～位（諧音祿位）、～合同春、～合，猜碼口令，數字六},僇,䍡
loeng1	lœŋ53	窿{窟窿，本字竉},𡃡{(白)嘈雜、吵鬧},聾{(白)～鬼、～佬，聾子；～嗙[pʰaŋ53]嗙[pʰaŋ53]，聾得很},竉{孔穴，俗字窿}
loeng3	lœŋ55	篢{箱籠，本字籠；地名用字},籠{(白)比較大的箱子}
loeng4	lœŋ21	䪊{馬䪊頭},𡃡{大聲},龍,隆,躘{躘蹱},蘢,聾{耳聾，聾啞},籠{蒸籠，燈籠；馬～頭，馬脖套，本字䪊/龓},窿{穹窿；煤礦坑道},礱,矓,癃,瓏,瀧{急流的水},漋,櫳,朧{朦朧，朧明},曨,嚨
loeng5	lœŋ24	儱,隴,籠{籠統，箱籠},攏{合攏，靠攏},壠{同壟字},壟{壟斷，田壟}
loeng6	lœŋ22	㟖,躘{(又)},衖{里衖，同里弄},弄{玩弄，里弄},哢{鳥吟}
lon1	lon53	攣{(語)鑽入}
lon2	lon33	𢺈{(白)聚積，亞啲剩菜～做一碟得喇}
lon4	lon21	圝{團圝；圓形，～檯},𢺈{聚；擇},鸞,鑾,灤,欒{欒樹；〈語〉（飯食）乾而難嚥下},巒,孿,圞{同圝字}
lot2	lot3	㗚{(語)～人，騙人}
lot3	lot5	捋{(白)滑落，～～襰襰，褲子下滑貌；滑～～，滑溜溜，黑～～，黑溜溜}
lu1	lu53	嚕{嚕囌，咕嚕},黸{鑊～，鍋灰}
lu2	lu33	滷{(又)打～子，勾芡},轤{(白)的[tek5]軲[ku33]～，一種遊戲，在斜板上擊銅元向前滾，以遠近決勝負}
lu3	lu55	嚕{象聲詞，嘟[tu55]～咑[ta55]喇[la55]，東西掉落聲；滾～～，滾動貌；案，滾動貌元代作骨碌碌，又作骨嚕嚕}
lu4	lu21	壚,鸕{鸕鶿},鱸{鱸魚},驢{(又)},顱,鑪,轤{轆轤},覼,蠃{同螺字},螺{田螺，螺旋，陀螺},蘆{蘆葦},艫,臚,腡{手指紋},罏,纑,盧,爐,瀘,櫨,廬{茅廬}
lu5	lu24	擄,鹵{鹵素，潟鹵},魯{粗魯，魯莽；姓},鑥,虜,磠,瀂,滷{滷水，滷蛋},氌,櫓,擼{動也}
lu6	lu22	潞,鷺{鷺鷥},露,酪{酒類},輅,路,賂{賄賂},蕗,璐
lui1	lui53	擂{(白)打、揍},𨀤{鑽入，～落去，擠進去；栽倒},虆{(白)牛口～，牛籠嘴},蔂{(白)牛口～，牛籠嘴}
lui4	lui21	嫘,雷,鐳,虆{藤蔓；土筐},蕾{芭蕾舞，蕾絲},蔂{同虆字；同欙字},羸,罍,纍{繩索},縲,累{果實累累，累贅},欙{山行用具},檑,樏,擂{擂臺，擂鼓}
lui5	lui24	㿔,蘽,藟,蕾{花蕾，蓓蕾},纍{堆積},絫,累{積累，傷痕累累},礨,磊,癗,漯{同㶟/灅字},壘{堡壘，壘球},儽,儡{傀儡}
lui6	lui22	䓞,類,酹{酹酒，奠酹},誄,耒,累{勞累，連累},礧,礌{礌石},淚,戾{暴戾，乖戾},唳
luk3	lok5	碌{(語)量詞，段，一～木；車～，線軸兒；花哩花～，花裏胡哨}
lun5	lun24	卵{雞卵，卵子，卵脬}
lun6	lun22	亂
lung2	loŋ33	啷{(語)鈴[leŋ55]～佬，貨郎}
lut5	lut24	捋{捋袖，捋鬍鬚},酹{(又)}
lyu4	ly21	膢{(又)},驢{毛驢，驢崽},閭
lyu5	ly24	侶,鋁,褸{襤褸},膂,縷{絲縷，一縷},穭,稆,漊{小雨不絕貌},櫚,梠,旅,履{(習)鞋履，履歷，讀同屢},屢,呂,僂{傴僂；迅速}
lyu6	ly22	慮,濾
lyun4	lyn21	攣{痙攣},聯{(語)縫製}
lyun5	lyn24	孌,臠,脟{同臠字}
lyut5	lyt24	冽,鴷,鋝,迾,趔,裂{斷裂，裂開},脟{脅肉；腸間脂},綟{麻綟},烈,洌,捩{轉捩點},挒,埒,咧{咧嘴},劣{惡劣，劣質},列{排列，列隊；量詞，排}
m2	m̩33	呣{表疑問}
m6	m̩22	呣{表答應}
maa1	ma53	么{同嗎字},貌{(語)～乎[hu21]，副詞，頗、蠻，貌似乎之省且語流音變，俗作嗎胡},螞{螞螂（蜻蜓）},摩{摩挲（按着移動）},巴{(白)摟、抱；抓、撓；～望[moŋ22]，盼望、巴不得，原讀的逆同化},孖{(訓)孿生、連帶，與巴旁轉；雙孖井，古井又泛指地名，現爲文物點},嚜{語氣詞},嗎{語氣詞，表疑問}
maa3	ma55	嘛{喇嘛；唵嘛呢叭咪吽},馬{馬虎；〈語〉又音，～騮[lɐu55]，猴子},嬤{俗呼母},媽{媽[ma21]媽，姑媽}
maa4	ma21	嗎{官話用字，什麼，幹嗎？},麻{黃麻；麻瘋，同痲瘋},蟆{蝦蟆，又作蛤蟆},痳{同痲字},痲{痲瘋，痲疹},嫲{粵字，祖母，一說與嬤同源，本地稱阿奶或奶奶},嘛{助詞}
maa5	ma24	傌{象棋紅方棋子名},馬{騎馬，馬戲；〈語〉～騮[lɐu21]，猴子，又作馬留/馬流/獁騮/馬𧳽/馬𤠑，一說源自沐猱},螞{螞蟻，螞蟥；～螂扛，同馬螂扛，螳螂},碼{尺碼},瑪,獁{猛獁},榪{榪槎},嗎{嗎啡}
maa6	ma22	傌{漢代刑罰；同罵字},駡{同罵字},螞{螞蚱},罵{罵人},禡,榪{牀頭橫木}
maai1	mai53	瓢{(訓)本義瓢，～瓜，瓠子，～殼，瓠子做成的瓢；案，民族語對音與瓢同源，上古宵部}
maai4	mai21	埋{埋伏，埋怨；～口，傷口癒合},霾
maai5	mai24	蕒,買
maai6	mai22	勱,邁,賣{買賣，賣報，燒賣}
maak2	mak3	㓦,擘{巨擘，擘畫；掰、張，～開口，張開嘴},掰{(訓)訓讀擘}
maak3	mak5	嚜{(語)瘦～喀[kʰak5]，很瘦，與蜢對轉},𢫦{(白)砍、鋤，～鉤[kɐu53]，鋤頭}
maam2	mam33	凹{(訓)口～，老人牙掉後口腔四周肌肉內陷；即窞之音轉（端組、泥明母旁轉），深坎},窞{(白)口～，老人牙掉後口腔四周肌肉內陷，端組、泥明母旁轉，俗字凹}
maan1	man53	扳{(白)扳倒，扳回；通攀字，攀、扶},𢺳{俗字，扳、扣，本字扳；攀、扶，本字攀},攀{(白)攀、扶}
maan4	man21	蔓{蔓菁},鬘,饅{饅頭},頑{(訓)～皮，～固，訓讀蠻},謾{欺謾},蠻{蠻荒，野蠻；副詞，很（口語用貌乎，俗字嗎胡）}
maan5	man24	晚{晚上，早晚；排行最小的，～崽、～女、～叔}
maan6	man22	万{同萬字},鰻{鰻魚，電鰻},饅{(又)讀同曼},鏝,謾{謾罵},蔓{藤蔓，蔓延},蔄,萬,脕{肥澤也},縵,熳,澫,漫,曼{曼舞，曼妙},慢{慢車，快慢；〈語〉（稱物時）秤尾低},幔,嫚,墁,卍
maang1	maŋ53	杧{杧果},芒{芒果（杧果），麥芒，芒草}
maang3	maŋ55	䒐{(白)～～䒏[ɬaŋ55]䒏[ɬaŋ55]，隨隨便便、不正經},甿{(語)亞～，指示代詞，這裏}
maang4	maŋ21	厖{大；紛亂；姓},鋩,邙,茫,芒{芒種，光芒},硭,甿{曠野},牻,牤{牤牛},氓{流氓},忙,尨{長毛狗}
maang5	maŋ24	壾,蟒,莽{莽撞，魯莽},茻{草叢},漭
maap3	map5	凹{(訓)～地，窪地；太公～，地名；即塌之音轉（端組、泥明母旁轉），地下也},塌{(白)凹，端組、泥明母旁轉，俗字凹}
maat3	mat5	𪒜{(白)黑～～，黑漆漆；㩢[fat2]～，誣賴、抹黑}
maat5	mat24	㩢{拭也，俗字抹},𪒜{黑也},鞨{鞨巾},襪{襪子，鞋襪},抹{抹布，抹乾，本字㩢}
maau1	mau53	䅦{禾虛貌；〈語〉虛鬆不實，一說泡的白讀},泡{(語)虛鬆不實，本字䅦，另一說泡的白讀}
maau3	mau55	猫{(文)},貓{(文)}
maau4	mau21	旄{幢；旄牛},髦{髮也；時髦},錨{(又)本讀},酕,蟊,蝥,茅{茅屋，茅草},矛{矛盾，長矛},氂{氂牛},毛{毛筆，鴨毛}
maau5	mau24	卯,鉚,茆,泖,昴,峁
maau6	mau22	冒{感冒，假冒，冒煙},貌{相貌，禮貌},芼,耄,眊,皃,瑁,毷,旄{同耄字},帽,媢
mai1	mɐi53	咪{麥克風},𠜱{(白)}
mai3	mɐi55	咪{(語)否定詞，冇使的合音，別，～過來},瞇{同眯字，瞇眼},睸{閉目},眯{眯眼；拜眼～，打瞌睡；～沉[ʃɐm21]沉[ʃɐm21]，眼眯打瞌睡}
mai4	mɐi21	蒾,醚{乙醚},迷{迷路，迷信}
mai5	mɐi24	媄,鎂{鎂棒，鎂光燈},脒,美{美麗，優美},米{大米，米粉；平方米},瞇{同眯字，塵物入眼},眯{塵物入眼},渼,洣
mai6	mɐi22	袂,謎{謎語，猜謎}
mak2	mɐk3	掰{(訓)又音},擘{(又)用指甲掐、掰、剝}
mak3	mɐk5	嘜{(外)罐頭盒，英語mug；～頭，模樣或招牌，英語mark；豬～，蠢豬，詈語},墨{(白)蚊～，墨蚊、小咬},嚜{同嘜字}
mak5	mɐk24	万{万俟（複姓）},默{沉默，默寫},纆,癦{粵字，痣，本字墨，本地稱麻雀斑},墨{筆墨，墨水},嚜{通默字},嘿{同默字},冒{古人名，冒頓}
mak6	mɐk2	默{(又)～噻[ɬɐk2]，死亡}
mam3	mɐm55	𩛎{～～，飯，童語，唵唵的順同化},𩜠{同𩛎字}
man1	mɐn53	文{(白)一～銀紙，一塊錢；細～崽，小孩子}
man2	mɐn33	抆{(白)擦拭；推，～屎蟲，蜣螂，～土機，推土機}
man3	mɐn55	呇{(語)泉水，又作汶字，本字湓；地名，呇屯（在馬山縣），呇塘（在賓陽縣）},燜{(訓)訓讀炆},炆{燒、燉},湓{(白)泉水，俗字呇/汶},汶{(語)泉水，又作呇字，本字湓}
man4	mɐn21	岷,馼,雯,闅,閿,閩{閩越},蚊{蚊子，蚊香；～墨[mɐk5]，墨蚊、小咬},苠,芠,聞{新聞，聽聞},緡,紋,碈,甿{田民，古讀同萌},珉,玟,泯{(白)朽，亞條柱蔸（柱子）～喇},氓{百姓，古讀同萌},民,旻,忞
man5	mɐn24	僶,黽{黽勉；〈又〉黽池縣},鰵,閔,笨{(白)鈍，刀～、針～},笢,皿{(又)讀同敏},湣,泯{泯滅，泯然},暋,敏{靈敏，敏捷；〈語〉跳皮、淘氣},抿{抿酒，抿嘴},抆{拭也},憫,愍,呡,吻,刎
man6	mɐn22	問{問題，訪問},聞{(古)名譽、名望},絻,紊{紊亂，有條不紊},璺{裂痕},汶{汶川縣，汶河}
mang1	mɐŋ53	掹{俗字，拉、扯、拔，本字絣},絣{(白)拉、扯、拔，俗字掹}
mang3	mɐŋ55	繃{(白)繃緊，面～，繃着臉、生氣；～炕[kʰɐŋ55]，暴躁；癒合，傷口～喇}
mang4	mɐŋ21	㬟{(訓)未曾的合音，本地方言字𱤜（⿰未曾）},𱤜{合音字，未曾的合音，又作朆/㬟字},萌,盟,甍,朆{(訓)未曾的合音，本地方言字𱤜（⿰未曾）},䒐{䒐䒏，神不爽也}
map3	mɐp5	凹{(訓)又音},塌{(白)又音}
mat2	mɐt3	搣{撕、掐、掰，與𢲼旁轉（端組、泥明母旁轉）},黴{(訓)發～，發黴，或與沫/歿同源，上古月部},霉{(訓)}
mat5	mɐt24	勿,謐,蜜,蔤,芴{蒠菜；有機化合物},物,沕{沕穆},密,宓{安靜},嘧
mau1	mɐu53	踎{蹲，～監，坐牢，一說本字貓}
mau4	mɐu21	侔,麰,鍪,謀,蛑,繆{綢繆},眸,牟,毪,哞,呣{同謀字；象聲詞}
mau5	mɐu24	某,畝,牡{牡丹}
mau6	mɐu22	䓮,貿,謬{謬論，荒謬},袤,茂,繆{同謬字，紕繆；姓},瞀,楙,懋
me1	me53	乜{～斜[tʃʰɛ21]，斜視},𧋦{(白)～朾[tʃiɐŋ21]，蜻蜒，本字尾},羋{羊叫聲},尾{(白)～朾[tʃiɐŋ21]，蜻蜒，俗字𧋦},孖{(白)～指，六指},哶,咩{羊叫聲，羊～咩[me21]，童語}
me2	me33	乜{俗字，～笡[tʃʰɛ33]，歪斜，本字佊；～屎，感情脆弱、愛哭},歪{(訓)斜，本字佊，俗字乜},佊{(白)歪，～笡[tʃʰɛ33]，歪斜，俗字乜；～屎，感情脆弱、愛哭}
me3	me55	孭{動詞，揹，本字不明}
me4	me21	乜{(白)～斜[ɬɛ21]，醉態},瀰{(白)～頭，乳房；～水，乳汁；又作彌字},彌{(白)同瀰字，乳房}
me5	me24	冇{俗字，不、別、沒，本字靡，本地只表否定不表沒有（不存在義），不單用，必須以詞組（冇有、冇是）成句；用於句末則表疑問，作反覆疑問句},靡{(白)否定詞，俗字冇},嘸{否定詞}
me6	me22	乜{姓}
men1	mɛn53	翻{(白)～開，～書}
men2	mɛn33	抿{(白)～嘴，撇嘴（表輕蔑或不高興），～口～嘴/舌，撇嘴貌，又讀[mem33]}
men3	mɛn55	璺{(白)～峻[ɬɛn55]，邊緣；勉強}
met3	mɛt5	蔑{(白)末也，～～，末名，～崽，小兒子，～手指，小手指}
met6	mɛt2	滅{(語)程度深，灰～～，非常灰暗}
meu1	mɛu53	喵{(白)}
meu3	mɛu55	猫{(白)同貓字},貓{(白)花貓，貓狗}
mi1	mi53	咪{～～摩摩，動作慢，一說本字靡靡磨磨},𧋦{俗字}
mi3	mi55	咪{貓咪，笑咪咪，唵嘛呢叭咪吽},瞇{同眯字，笑瞇瞇},眯{笑眯眯},沕{(語)潷}
mi4	mi21	䉲,𪎭{𪎭子},黴{(又)},麋,鶥,靡{奢靡，靡費},霉{(又)},鎇,醾,郿,蘼,薇,縻{羈縻，綆縻},糜{粥；糜爛；同𪎭字，糜子},眉,瑂,獼,猸,瀰{瀰漫},濔,溦{小雨},湄,楣,微{微小，細微，稍微（口語用稍爲）},彌{彌補，彌月},嵋,冞,䕷
mi5	mi24	亹{亹亹},靡{披靡，風靡，俗讀奢靡之靡},艉,羋{姓},渳,敉,弭,屘{俗字，末尾的、最小的，本字尾},尾{尾巴，結尾},娓
mi6	mi22	味{味道，香味，滷味，一味},魅,菋,沕{(語)打～子，潛泳},未,寐{夢寐以求},媚{明媚}
miak5	miɐk24	䥑,麥{麥子，小麥；～線、～串，麥穗},驀,霢,陌{陌生},貘,貊,貉{同貊字},覛{察看},脈,眽
miang1	miɐŋ53	螟{(白)塘～，蜻蜓}
miang2	miɐŋ33	蜢{(白)蚱蜢}
miang3	miɐŋ55	蜢{(語)瘦～躿[kʰiɐŋ55]，瘦貌，與嚜對轉}
miang4	miɐŋ21	盲,鄳,虻{牛虻}
miang5	miɐŋ24	䁅{目有餘視},黽{蛙屬},錳,蜢{蚱蜢},艋,猛,勐
miang6	miɐŋ22	䁅{䁅盯，瞋目},孟{孟春，孟子}
mik2	mek3	掰{(訓)又音},擘{(又)用指甲掐、掰、剝}
mik5	mek24	冪,覛{同覓字},覓{尋覓，覓食},蓂{菥蓂},糸{細絲},汨
min4	min21	棉,𥾝{(白)細，切/抹～啲，切細點，俗字綿},綿{海綿，綿密；〈語〉細，切/抹～啲，切細點，本字𥾝},眠
min5	min24	丏,黽{黽池縣},鮸,靦{靦腆},腼{腼腆，同靦腆},緬{緬懷，緬甸},眄,澠{地名，澠池（在河南）},湎,沔,愐,娩{分娩},勔,勉,冕,免,偭,俛{通勉字}
min6	min22	面{面對，外面},麵{同麪字},麪{麪條，麪粉}
ming4	meŋ21	冥,鳴,銘,螟{螟蛉},蓂{蓂莢},瞑,溟,洺,榠,暝,明,名{名字，名聲}
ming5	meŋ24	皿{器皿},酩,茗
ming6	meŋ22	命{命令，救命}
mit5	mit24	滅{消滅，滅火},𥾝{細也},衊{誣衊},蠛{蠛蠓},蔑{輕蔑，蔑視},篾{竹篾，篾青}
miu1	miu53	喵,瞄{(白)瞄一眼，偷瞄}
miu4	miu21	描,鶓,苗,瞄{瞄準}
miu5	miu24	杪{樹杪，歲杪},邈{同藐字},藐,緲,窈{窈窕，讀同渺},秒,眇,渺,淼,杳{杳無音信，讀同渺}
miu6	miu22	妙,繆{姓},玅{同妙字},廟
mo1	mo53	么{同麼字},麽{同麼字},麼{甚麼，幺麼小醜},魔,饃{饃饃，泡饃，本字𩞁},糢,模{模範；模子},摹{摹仿、摹擬，又作模仿、模擬},摸{(又)夜摸},摩{摩擦，觀摩，按摩；〈語〉咪[mi53]咪[mi53]～～，動作慢，一說本字靡靡磨磨},嬤{老婦，嬤[mo21]～},仫{(習)仫佬族，讀同麼}
mo2	mo33	冒{(語)水從地下往外冒或慢慢流出，水～出來喇、～水井}
mo3	mo55	冒{(語)從地裏野生出來，亞蔸番桃是～出來嘅，冇是種取},無{(語)南～（喃嘸）佬，道士、道公},嘸{(語)喃～（南無）佬，道士、道公}
mo4	mo21	摹{臨摹，摹本，描摹},饃{(又)},蘑{蘑菇},膜{膜拜},無{(語)～該，勞駕；～氣～緊，不緊不慢、不着急},模{(又)}
mo5	mo24	磨{(語)禁[kʰɐm53]～，禁得做、不易做完}
moek2	mœk3	摸{約摸，同約莫，前字調類化；〈語〉掏，～荷包},莫{(白)約莫，又作約摸，前字調類化}
moek3	mœk5	霧{(語)落[lak24]～，落霧，本字霧，上古幽部與覺部對轉}
moek5	mœk24	仫{(書)},霂,鏌,鉬,鄚{鄚縣},邈{遠也，渺也},莫{莫非；姓},苜,膜{薄膜},穆,睦,目,瘼,牧,漠,沐,木,幕,寞,坶
moeng1	mœŋ53	蓬{(白)（薯類）膨鬆粉麪，俗字蒙/𡁏},𡁏{(語)（薯類）膨鬆粉麪，本字蓬}
moeng3	mœŋ55	檬{檸檬，檸檬鴨}
moeng4	mœŋ21	㠓,𡁏{言不明},鸏,蒙{蒙受，啓蒙；姓},艨,礞,矇{失明；矇騙，矇混},瞢{目不明；～鑿鑿，模糊看不清},獴,濛{濛濛細雨，溟濛，灰濛濛},朦{朦朧},曚,懞{敦厚貌},幪,尨{尨茸}
moeng5	mœŋ24	懞{同懵字},蠓{蠓蟲},懵{懵懂}
moeng6	mœŋ22	夢
mon1	mon53	翻{(白)從土裏或袋裏往外掏東西，～番薯、～荷包}
mon2	mon33	抿{(白)因無牙而用牙齦咬，慢慢～、～取，又讀[mɐm33]}
mon3	mon55	捫{(白)～自[tʃi55]，怕羞}
mon4	mon21	瞞{(又)},門{(語)又音，疑問代詞，哪[na33]～，什麼}
mot3	mot5	沒{(白)水～過頭，本字𩑦},𩑦{(白)水～過頭，又作沒字}
mot6	mot2	沒{(白)打～子，潛泳，本字𩑦},𩑦{(白)打～子，潛泳，又作沒字}
mu1	mu53	巫,誣,摸{撫摸，偷摸；盲～～，摸黑兒，在黑夜摸索着行動}
mu2	mu33	母{(白)姨～，姨媽}
mu4	mu21	劘,鵐,謨,藦{蘿藦},蕪,磨{(動)磨刀},無{有無，無論},毋{毋庸置疑},嫫
mu5	mu24	㵲,𧿹,鵡{鸚鵡},鉧,茻{宿草},舞{跳舞，舞龍},碔,珷,潕,母{母親，父母},武,拇,憮,廡,嫵,姥{老婦人},姆{保姆，歐姆},侮
mu6	mu22	務,鶩,騖,霧{霧水，大霧},耱,礳{地名，礳石渠（在山西）},磨{(名)石磨},暮,戊{戊戌},慕,婺,墓,募
mui3	mui55	妹{(白)妹崽（舊時指丫鬟）}
mui4	mui21	媒,黴{發黴，黴菌，讀同梅},霉{同黴字},酶,莓,脢{～肉、腰～，裏脊肉；背～，背骨兩側肌肉，泛指背脊；背～骨，脊樑骨；～頭，前胛},玫,煤,梅,枚{枚舉；姓}
mui5	mui24	每,浼
mui6	mui22	妹{姊妹，阿妹，表妹，堂妹},痗,瑁{(又)玳瑁},沬,昧{冒昧，昧心}
muk3	mok5	𢷕{敲打，～一棍，與㩧旁轉}
mun4	mun21	亹{亹源},顢,鞔,門{大門，門口；疑問代詞，哪[na33]～，什麼},鍆,蹣{跨越},瞞,璊,捫{捫心},們
mun5	mun24	滿,蟎
mun6	mun22	悶{煩悶，悶熱},燜{燜飯，油燜},懣
mung5	moŋ24	惘,魍,輞{車輞},蝄,罔,网,網
mung6	moŋ22	妄,望{希望，望見；巴[ma53]～，盼望、巴不得，前字受後字逆同化},忘{忘記，遺忘}
mut5	mut24	妺,𩑦{頭潛入水中，後作沒},靺,茉,秣,沫{泡沫},沒{沉沒；沒有},歿{亡歿},末,抹{抹殺，塗抹；〈語〉切（成細絲或細末），～綿（𥾝）啲，切細點}
myu3	my55	彌{(語)煩悶；膩煩，亞種菜我吃～啊}
naa1	na53	那{姓，俗讀那邊之那},𪐀{(文)粘貼；～褦[niɐŋ55]，牽連、牽扯，另一說本字拏/挐},𤶸{俗字，傷疤，本字𤶠；補～，補丁；疙[kɐt2]～，活結，引申爲吝嗇},𤶠{傷疤，俗字𤶸，聲母演變同𪐀/䵙字；補～，補丁；疙[kɐt2]～，活結，引申爲吝嗇}
naa2	na33	乸{俗字，母、雌，本字女，上古魚部},哪{哪個，哪怕；疑問代詞，～門[mun21/mon21]，什麼}
naa3	na55	南{(語)～無（喃嘸）佬，道士、道公},喃{(語)～嘸（南無）佬，道士、道公}
naa4	na21	哪{哪吒},鎿,挐{同拏字},拿{捉拿，拿手，本字拏},拏{牽也},嗱{嘆詞，表指向，或與喏/諾同源}
naa6	na22	哪{語氣詞},𦰡,那{那邊，那些；地名用字},娜{人名用字，讀同那}
naai3	nai55	帶{(白)連帶，講話東～西～，講話東拉西扯，端組旁轉，俗字𠮨}
naai5	nai24	乃,鼐,迺,艿{芋艿},氖,嬭,妳{同嬭字},奶{牛奶，奶[nai21]奶}
naai6	nai22	佴{姓},錼,褦{(書)},萘,耐,耏{去頰鬚刑},柰,奈,倷{吳語字，你}
naak5	nak24	喏{同諾字},鍩{放射性化學元素},諾{承諾，諾言},搦{(書)持也}
naam1	nam53	喃{(白)喃經（唸經）；嘮叨}
naam2	nam33	欖{(白)橄欖，烏～，黑橄欖；喉～，喉結}
naam3	nam55	𨂾{俗字，跨、邁，應由揇引申而來}
naam4	nam21	南{南方},蝻{蝻子，蝗蝻},蚺{(習)～蛇，蟒蛇},萳{草名},男,楠,抩,囡{吳語字，女孩},囝{同囡字},喃{(文)呢喃，喃喃自語}
naam5	nam24	揇{搦，與㘝對轉},萳{草長弱貌},腩{牛腩，肚腩},湳
naam6	nam22	婻
naan3	nan55	㫱{(白)蚊蟲叮咬起的包},𦍀{(白)絎，粗縫}
naan4	nan21	難{難易}
naan5	nan24	㫱{溫溼},赧{羞赧，赧然，赧顏},戁{恐懼}
naan6	nan22	㫱{赤色},𦍀{縕也},難{患難}
naang1	naŋ53	䑋{(白)（嬰兒）壯實、胖；（植物）茁壯},襠{(白)褲～，褲襠，端組旁轉，俗字𧟘},囊{(白)囊膪；泡[mau53]（䅦）～肉，囊膪、奶脯肉}
naang3	naŋ55	儾{(語)假借字，吊～～，吊貌、垂掛貌，或源自當，端組旁轉},鬤{(白)鬞～，窩囊、不整潔}
naang4	naŋ21	囊{行囊，囊括},饢{一種烤製成的麪餅},穰{(又)同瓤字},瓤{瓜瓤},囔{囔囔，嘟囔}
naang5	naŋ24	擃{同攮字},饢{拼命往嘴裏塞食物},曩,攮{用刀攮}
naang6	naŋ22	儾{寛緩},齉{鼻塞}
naap3	nap5	㘝{(白)搛，～菜；～嘴魚，一種尖嘴魚}
naap5	nap24	㘝{攝取，與揇對轉},鈉,衲,納{出納，收納；〈語〉（植物子實）飽滿},囡{同㘝字},吶{吶喊，嗩吶},䪏
naat2	nat3	焫{燎，火～着眉毛喇；烙，～機[kɐi53]，烙鐵；與熱同源，上古月部}
naat5	nat24	捺{撇捺，按捺}
naau1	nau53	孬{俗字，孬種，本字𢜸}
naau4	nau21	呶,鐃,錨{拋錨，讀同鐃},譊,蟯{(又)},硇,猱,橈{曲也},撓{阻撓，百折不撓},憹{懊憹},巎,峱
naau5	nau24	堖,腦,瑙,惱
naau6	nau22	淖{泥淖},鬧,臑{牲畜前肢}
nai4	nɐi21	伲,霓{(習)霓虹，霓虹燈},鈮,跜,臡,泥{泥土},怩,尼{尼姑，尼龍，尼古丁；姓},妮,坭,呢{呢絨，呢喃},倪{(習)端倪；姓}
nai5	nɐi24	旎,柅
nai6	nɐi22	膩{油膩，膩煩}
nak2	nɐk3	蹃{(白)踩}
nak5	nɐk24	瘧{瘧疾},謔{戲謔},虐{虐待}
nam1	nɐm53	耽{(白)傻、土氣，端組旁轉，由遲延義引申爲遲鈍，進而引申爲土氣，俗字恁},𦛚{(語)眼瞼浮腫}
nam3	nɐm55	揕{(白)（用尖物）扎、刺、戳，～一針，知、端、泥母旁轉}
nam4	nɐm21	腍{(語)（肉類）松軟、爛熟，～癟[pɛt2]癟[pɛt2]，軟爛，～善，人善良軟弱，與䪏或𥹉對轉，或爲燂之音轉（端組旁轉）}
nam5	nɐm24	恁{思考、想，俗字諗},諗{(訓)訓讀恁，思考、想},稔{熟稔，稔色，素稔}
nam6	nɐm22	𦛚{肥貌，與䐺旁轉}
nan1	nɐn53	戁{(白)肉麻；噁心，～相，令人噁心的樣子}
nan2	nɐn33	撚{(語)擺弄、玩弄，～化，捉弄，～人，整人}
nang1	nɐŋ53	囊{(語)～肌[kɐi53]，瘡疤，與囊（皮囊）同源，上古陽部，俗作𤹍雞},𤹍{俗字，～雞，瘡疤，與囊（皮囊）同源，上古陽部，本字囊肌}
nang3	nɐŋ55	褦{(語)又音；狗打～，狗交配}
nang4	nɐŋ21	能{才能，能夠}
nang5	nɐŋ24	能{(語)疑問代詞，同[tœŋ21/tɐŋ21]～，怎麼，哪樣的合音}
nang6	nɐŋ22	蹬{(白)蹭[ɐŋ55]～，頹笨、不開竅，端組旁轉}
nap2	nɐp3	撘{(白)（用棍子）插（在地上），端組旁轉}
nap3	nɐp5	粒{一粒米，飯粒，來母讀如泥母；該量詞可表示塊、個，兩～豬肉，兩塊豬肉}
nap5	nɐp24	𣲷{潮溼，與溚旁轉},𥹉{黏糊，與腍對轉，與搭旁轉；動作慢，～稍[ʃau33]，不利索、動作慢}
nap6	nɐp2	沓{(白)重～～，沉甸甸，端組旁轉}
nat2	nɐt3	苶{(白)身～、㾓～，痠軟}
nat5	nɐt24	吶{同訥字},訥,肭{肥貌}
nau1	nɐu53	嬲{俗字，生氣、憎恨，本字獳，另一說本字惱},獳{(白)生氣、憎恨，俗字嬲，另一說本字惱}
nau2	nɐu33	妞,鈕{按鈕，電鈕，旋鈕；同紐字，紐扣},紐{紐扣，樞紐，紐帶},狃,杻{木名},扭{扭轉，彆扭，扭捏},忸{同狃字；〈又〉忸怩}
nau6	nɐu22	檽,腬{膩},耨,獳{犬怒貌；姓}
ne1	ne53	𪐀{(白)粘貼}
ne2	ne33	呢{句末語氣詞，我嘅鎖匙放在哪啲～？}
ne4	ne21	呢{(語)表祈求或指向，又作嗱字},嗱{(白)表指向，一般作呢[nɛ21]字}
ne5	ne24	呢{(語)表提請注意或指向}
nem1	nɛm53	拈{(白)拈起，拈鬮，與鑷對轉，與掂旁轉},稔{同棯字},棯{(白)花～，番桃、桃金娘果實，花爲番的音變，竇[tɐu55]～，倒捻子、桃金娘，竇爲倒的音變，又作稔/捻字},捻{同拈字；同棯字}
nen2	nɛn33	捻{同撚字，摁、壓，與捏[nɛt2]對轉},輾{水輾，後作碾},輦{車輦},碾{碾碎，水碾},攆{攆走},撚{搓揉，～火媒（紙媒兒）；摁、壓，～燈制（燈開關），與捏[nɛt2]對轉}
nep3	nɛp5	嗒{(白)（蚊蟲）咬、（馬蜂）蜇，端組旁轉，俗字囁},鑷{(白)鑷子；（用工具）夾、拈，與拈對轉},囁{(訓)（蚊蟲）咬、（馬蜂）蜇，即嗒之音轉（端組旁轉）}
nep6	nɛp2	沓{(白)軟～～，身軟無力，端組旁轉}
net2	nɛt3	捏{(語)扭～，舉止言行不大方}
net3	nɛt5	䵒{(白)粈[niu53]～～，很黏}
net6	nɛt2	捏{(白)按壓，與撚[nɛn33]對轉}
neu1	nɛu53	粈{(白)又音，～褦[nɐŋ55]褦[nɐŋ55]，很黏}
neu4	nɛu21	嫋{(白)細長柔軟}
ng4	ŋ̍21	吳,鼯,鋙{錕鋙},郚,蜈{蜈蚣},珸,浯,梧{梧桐},峿{嶇峿},唔{嘆詞，思忖聲},吾
ng5	ŋ̍24	五{五個，十五},迕,牾,旿,忤,嗯{表疑問},午,伍,仵{仵作；姓}
ng6	ŋ̍22	互{(又)俗讀},誤,痦,焐,晤,摀,捂,悟,寤,嗯{表答應}
ngaa1	ŋa53	枒{枒杈，又作椏杈},椏{椏杈，又作枒杈}
ngaa6	ŋa22	枒{木名},𧧝{～𧨊，囉唆、糾纏}
ngaai1	ŋai53	𠊎{俗字，～話，客家話，本字我，摹客家音}
ngaai4	ŋai21	呆{呆板，本字獃},騃,磑{磑磑},睚,皚,獃{獃板},涯{天涯，生涯},捱{捱打，捱苦；被，～講，被批評},挨{同捱字},崖{山崖，懸崖},堐
ngaai6	ŋai22	砹,艾{艾草，艾葉，艾滋病},礙
ngaak5	ŋak24	噩,𥔲,齶{軟齶，硬齶，齶化},鶚,鱷,鰐,顎{上顎，下顎，顎裂；同齶字},鍔,鄂,諤,萼,愕,崿
ngaak6	ŋak2	岳{(又)},鸑{(又)},嶽{(又)}
ngaam3	ŋam55	啱{俗字，剛剛、恰好、合適，一說本字嚴/𧬌/諴}
ngaam4	ŋam21	儑{不慧},礹{同巖字},癌{癌症，肝癌},玵,巖{巖洞，巖壁},嵒,岩{岩石，岩漿}
ngaam5	ŋam24	㜝{含怒貌}
ngaam6	ŋam22	儑{傝儑}
ngaan4	ŋan21	研{(語)碾、砑，與扤對轉},頑{頑童，冥頑},虤
ngaan6	ŋan22	岸,豻{野狗；獄也},犴{狴犴；獄也；本作豻}
ngaang3	ŋaŋ55	戇{(訓)傻、呆，癡～～，瘋癲貌，或爲愚戇的合音（愚字古疑母），與愕對轉}
ngaang4	ŋaŋ21	卬{我也；通昂字；姓},昂{昂首}
ngaap3	ŋap5	哈{(語)開口～～，開口發呆},𡀾{(語)又音},噏{(語)又音}
ngaat3	ŋat5	兀{(語)又音，翹[hɛu53]～～，嘴噘着}
ngaat5	ŋat24	嚙{(白)},齧{(白)啃、咬},齕{(白)啃、咬},扤{(語)摩擦，～痕/癢、牛～樹，與研對轉},囓{(白)}
ngaau3	ŋau55	嗷{(語)詞綴，深～～，（眼）凹，韌[ȵɐŋ55]～～，（肉食等）韌}
ngaau4	ŋau21	嗷{嗷嗷待哺},鼇,鰲,驁,餚,鏖{(又)},遨,螯,肴,聱,翱,璈,獒,爻,熬{熬夜；熬肉},淆,洨,殽,敖,摮{擊；〈語〉搖晃，俗字𢳆},廒,嶅,崤
ngaau6	ŋau22	傲,鏊{烙餅用具},樂{(古)仁者樂山},奡
ngai1	ŋɐi53	磑{(白)哀求，又或吟淒的合音，俗字𠼮/𠱓}
ngai4	ŋɐi21	倪{(書)},齯,麑,鯢,霓{(書)},輗,蜺{寒蟬},猊,洈,峗{三峗},婗
ngai5	ŋɐi24	峗{山高貌},顗,頠,隗{高；姓},硊{磈硊}
ngai6	ŋɐi22	乂,𨺙,詣,蓺,艾{自怨自艾，俗讀艾草之艾},羿,睨{睥睨},毅{毅力，剛毅},栺{枍栺},堄{埤堄},囈,刈{刈草，刈麥},倪{俾倪}
ngak3	ŋɐk5	呃{(語)欺騙，本字或爲眲，又或吟得的合音},眲{欺騙，或爲本字或爲吟得的合音，俗字呃}
ngam3	ŋɐm55	顉{(白)～頭，點頭，與𩪤對轉}
ngam4	ŋɐm21	吟{(白)～沉，嘮叨，古作沉吟，與噏/𡀾對轉},啽{寐聲}
ngan1	ŋɐn53	奀{俗字，瘦小，或爲伢身（小兒身）的合音}
ngan3	ŋɐn55	䟴{(習)搖晃，與扤對轉}
ngan4	ŋɐn21	嚚,齦{牙齦},齗,銀,鄞,誾,珢,狺,垠,圻{同垠字}
ngan6	ŋɐn22	垽,憖
ngap2	ŋɐp3	𩕟{(又)},𩪤{(又)䆟[kʰɐp3]～，（女孩）怕羞}
ngap3	ŋɐp5	噏{(語)胡說，一說本字𡀾，與吟/啽對轉},𩪤{(又)～頭，點頭},𩕟{(又)},𡀾{(語)胡說，俗字噏，與吟/啽對轉}
ngap6	ŋɐp2	哈{(語)（魚）張口呼吸，魚浮頭～喇},𩪤{～頭，點頭，與顉對轉，又作𩕟字},𩕟{同𩪤字},𡀾{衆聲},歞{癡貌},岋{動貌}
ngat6	ŋɐt2	仡{壯勇},阢,疙{癡貌},杌{杌子},扤{動、搖，與䟴對轉},忔{心不欲也},屼,屹{屹立},圪{牆高貌},卼,兀{突兀，兀鷲}
ngau1	ŋɐu53	勾{(白)勾消；勾當},鉤{(白)魚鉤；鉤住},鈎{(白)同鉤字},軥{(白)軥心木},句{(白)曲也，俗作勾；句踐；高句麗}
ngau5	ŋɐu24	偶{配偶；偶然},藕,蕅,耦,朽{朽木，腐朽，不朽}
ngau6	ŋɐu22	吽{俗字，～哣，迷糊、不清醒，本地又指古板、難溝通，疑本字䠗逗/譳䛠}
nge1	ŋe53	伢{(白)牛伢[ŋe55]～，對小孩兒稱牛},椏{(白)～柴，杈枝},枒{(白)～柴，杈枝}
nge2	ŋe33	呀{象聲詞，推門聲，又作砑字},砑{(白)象聲詞，推門聲，又作呀字}
nge3	ŋe55	伢{(白)牛～伢[ŋe53]，對小孩兒稱牛},胾{(白)搭秤～，稱肉時爲補數搭配的肉、婦女改嫁帶的兒女的侮稱}
nge5	ŋe24	嘢{俗字，東西，買～，買東西，本字兒，即（物）兒，括號內爲省略，本爲物的兒尾小稱，演變構擬[*ȵie]➔[*ȵe]➔[ŋe]，聲調由平聲轉爲上聲反映疑問語氣；案，元·丁復《題畫馬爲方遠上人賦》唐人爲馬置馬監，奚官果是何物兒？《紅樓夢》第四三回，你這麽個阿物兒，也忒行了大運了！}
ngen1	ŋɛn53	齞{(白)齜、露齒；吝嗇，與忔對轉}
ngen4	ŋɛn21	研{(語)又音}
ngep6	ŋɛp2	哈{(語)㪗氣～～，氣喘吁吁}
nget2	ŋɛt3	忔{(白)～失[ʃɛt3]，吝嗇，與齞對轉}
nget3	ŋɛt5	兀{(語)翹[hɛu53]～～，嘴噘着；𣩢[lɛu55]～～，乾而瘦；皺[ȵɐu55]～～，皺巴巴}
nget5	ŋɛt24	嚙{(白)},齧{(白)又音},齕{(白)又音},扤{(語)摩擦，牛～樹，與研對轉},囓{(白)}
nget6	ŋɛt2	扤{(語)捱～、捱捱～～，磨蹭、捱時間}
ngeu3	ŋɛu55	嗷{(語)詞綴，哭～～，哭哇哇}
ngiak2	ŋiɐk3	岳{姓},鸑,嶽{五嶽}
ngiak5	ŋiɐk24	弱,鰯,額{額頭，匾額，數額},蒻
ngiang2	ŋiɐŋ33	䉴{(白)魚～，魚簍}
ngiang4	ŋiɐŋ21	䉴{袌也},𧟄,鬤{亂髮},蘘,穰{禾莖；同瓤字},禳,瀼{露濃貌},勷{劻勷},儴{因循，沿襲}
ngiang5	ŋiɐŋ24	䑋,卬{同仰字},仰{信仰，仰頭}
ngiang6	ŋiɐŋ22	䭐{餌也；將豆腐、苦瓜、油餜等掏空再塞入各種餡兒做成菜肴，～豆腐、～苦瓜、～油餜，俗字釀},釀{釀酒，醞釀},讓,硬{堅硬，硬是，硬撐（結實）},瀼{水名},攘{攘外安內，擾攘},壤{土壤},嚷
nging1	ŋeŋ53	扔{(白)}
nging4	ŋeŋ21	仍{仍然，仍舊},迎{迎接，歡迎，與逆對轉；〈語〉舉，～手、～頭，一說本字攍},艿{舊草未割新草又生},盈{充盈，盈利，笑盈盈},楹,攍,扔{扔掉}
ngo4	ŋo21	俄,鵝,鋨,訛,蛾{飛蛾，燈蛾；～䗃[kʰɛn24]，螻蛄、土狗},莪,硪,涐,峨,娥,囮,哦{吟哦},吪{行動；感化}
ngo5	ŋo24	我
ngo6	ŋo22	卧,餓,臥{臥室，躺臥}
ngu4	ŋu21	吳{(老派)},鼯{(老派)},鋙{(老派)},郚{(老派)},蜈{(老派)},珸{(老派)},浯{(老派)},梧{(老派)},峿{(老派)},吾{(老派)}
ngu5	ŋu24	五{(老派)},迕{(老派)},牾{(老派)},旿{(老派)},忤{(老派)},午{(老派)},伍{(老派)},仵{(老派)}
ngu6	ŋu22	互{(老派)俗讀},誤{(老派)},痦{(老派)},焐{(老派)},晤{(老派)},摀{(老派)},捂{(老派)},悟{(老派)},寤{(老派)}
nguk3	ŋok5	摝{(語)拜～～，打瞌睡}
ni3	ni55	呢{唵嘛呢叭咪吽；粵字，這，本字爾，本地用阿/亞，本字箇}
ni4	ni21	嶷{九嶷山},觺,禰{姓},疑{懷疑，疑問}
ni5	ni24	你,鉨,薿,禰{考廟},狔,擬,您{你的敬稱},妳{同你字，專指女姓},儗{僭越}
ni6	ni22	儗{佁儗},泥{拘泥}
niak5	niɐk24	蹃{踐也}
niang1	niɐŋ53	娘{(語)同孃字},孃{(白)老～，母親的敘稱}
niang3	niɐŋ55	娘{(白)同孃字},褦{(語)連着、粘連，本字不明},孃{(白)姨孃；阿～，母之妹}
niang4	niɐŋ21	娘{新娘，娘子，姑娘，老闆娘},孃{爹孃，孃家}
nik2	nek3	搦{(習)拿，與擰/拎對轉},𪙛{蛀牙},𪐌{黏；～身，出汗後衣服黏身}
nik5	nek24	䵒{黏也},𧏾,𣘗,鷊,鷁,鶂,鬩{鬩牆，讀同慝/匿},逆{逆風，忤逆，與迎對轉},虉,溺{溺水，溺愛，沉溺},暱,昵,慝{隠情飾非},惄,嶷{岐嶷},匿
nim1	nim53	拈{(文)},粘{粘貼；同黏字},棯{(文)}
nim4	nim21	鮎{鮎魚},黏{黏土，黏性；〈語〉結合得緊、無空隙，渠做嘅門板幾～},鯰{同鮎字}
nim5	nim24	淰{濁也；水流貌}
nim6	nim22	唸{唸書，唸經},驗{試驗，驗證},念{思念，想念},廿{(文)},埝{土埝，堤埝}
nin1	nin53	研{(又)},蔫{枯萎；食物不鮮}
nin4	nin21	年
nin5	nin24	涊,蹨
ning1	neŋ53	拎{(習)提，來母讀如泥母，俗字擰},擰{提，與搦對轉，本字拎，來母讀如泥母}
ning2	neŋ33	䉴{(白)又音}
ning4	neŋ21	凝{凝結，凝固},鬡,薴,聹,甯{通寧字},獰,檸,寧{安寧；寧可，寧願},宁{同寧字},嚀{叮嚀}
ning6	neŋ22	佞,甯{姓},濘{泥濘},泞{同濘字},擰{擰轉；倔強}
nip3	nip5	埝{凹},𠱃{俗字，凹，本字埝}
nip5	nip24	囁{囁嚅},𦛠{腫也},顳,隉,闑,鑷{鑷子},鎳,鄴,躡{躡手躡腳},菍,苶{疲倦},臲,臬,聶{姓},糵,涅,櫱,業,捻{用手指夾住，捏},捏{用手指夾住，捏緊，本字捻},嵲,孽,堨{璧間隙}
nit5	nit24	嚙{同齧字},𦛠{(又)},齧{齧齒},隉{(又)},闑{(又)},臲{(又)},臬{(又)},糵{(又)},涅{(又)},櫱{(又)},捏{(文)},嵲{(又)},孽{(又)},堨{(又)},囓{同齧字}
niu1	niu53	粈{(白)黏}
niu5	niu24	嫋{嫋娜，嫋嫋},鳥{鳥類，小鳥},褭,裊{裊繞},蔦,嬲{戲弄},嬝
niu6	niu22	尿{尿牀，屙尿；尿脬},脲,溺{通尿字}
njaa1	ȵa53	抓{(訓)白讀，握、拿},𠭯{(白)},摣{(白)},揸{(白)},抯{(白)}
njaa3	ȵa55	渣{(白)甘蔗～，豆腐～；絲瓜～，絲瓜絡，水瓜～，水瓜絡}
njaa4	ȵa21	伢{小孩子，本字𤘅},衙,蚜,芽{豆芽，發芽（口語稱爆芽）},牙,岈{嵖岈}
njaa6	ȵa22	廿{(白)二十，二啊[a22]的合音，啊[a22]爲十的弱讀},迓,訝,砑{砑平，砑光}
njaai2	ȵai33	跴{(白)},踹{(白)},踩{(白)踩單車}
njaai3	ȵai55	嘬{(白)嚼}
njaak3	ȵak5	嘖{(語)乾～～，水分少},逆{(語)不稱心}
njaam3	ȵam55	揇{(白)拃，張開大拇指與中指測長度；量詞，一～，一拃},滲{(白)滲漏，～水，水滲出，～水良田，自然保水田}
njaam6	ȵam22	㜝{(白)妒忌}
njaan4	ȵan21	顏{容顏；顏色}
njaan5	ȵan24	眼{眼睛，針眼；量詞，睄[ʃau21]一眼（掃一眼）},齴{高峻貌}
njaan6	ȵan22	贋,鴈,雁,贗
njaap3	ȵap5	匝{(白)～縐[ȵɐu55]，心裏煩躁；～鬇[ȵɐŋ55]、～鬇[ȵɐŋ55]鬇[ȵɐŋ55]，（頭髮、鬍鬚、麻線、雜草等）多而亂},𥀈{(白)皮膚刺癢，癢～～，非常癢},悒{(訓)心～，心煩，疑源自匝/劄/𥀈}
njaat3	ȵat5	軋{(語)粗～～，粗糙、粗澀}
njaau1	ȵau53	抓{(白)搔、撓，俗字撓},𢯎{俗字，搔、撓，本字抓}
njaau2	ȵau33	爪{(白)雞爪}
njaau3	ȵau55	糙{(白)韌、嚼不爛，～牛筋，韌[ȵɐŋ55]～～}
njaau5	ȵau24	咬{咬人，反咬}
njai3	ȵɐi55	跇{(白)執[ȵɐp3]～，孩童頑皮，又作跩字},跩{(白)擛[ȵɐp3]～，孩童頑皮，本字跇}
njak2	ȵɐk3	簎{(白)用筷子把軟食物掰成小塊}
njak5	ȵɐk24	瘧{(又)},謔{(又)},虐{(又)}
njam1	ȵɐm53	摻{(白)量詞，撮，一～毛}
njam2	ȵɐm33	飲{飲酒；飲料}
njam3	ȵɐm55	飲{(古)飲馬}
njam4	ȵɐm21	任{姓，俗讀責任之任},壬{壬子，六壬}
njam5	ȵɐm24	荏
njam6	ȵɐm22	任{責任，任務},餁,飪{熟也},賃{租賃},衽,腍{熟也},絍,紝{機縷也；縫紝（口語用縫紉）},恁{這，那},妊
njan2	ȵɐn33	韌{(白)食物有勁道；打恂～，打冷顫、顫抖}
njan4	ȵɐn21	人{人民，工人},儿{同人字},仁{仁義，果仁}
njan5	ȵɐn24	忍
njan6	ȵɐn22	䏰,韌{堅韌，韌性},閏,軔,認,訒,膶{粵字，禽畜的肝，本字潤，避諱肝/乾，本地以溼避諱肝/乾},肕{堅肉；同韌字},紉{縫紉},潤{滋潤，溼潤},孕{懷孕，孕婦},刃{刀刃，利刃},仞
njang3	ȵɐŋ55	韌{(語)（肉食等）韌，韌硬的合音},鬇{(白)匝[ȵap5]～、匝[ȵap5]～～，（頭髮、鬍鬚、麻線、雜草等）多而亂}
njap2	ȵɐp3	執{(白)撮、抓；量詞，一～米，一撮米；～跇[ȵɐi55]，孩童頑皮}
njat5	ȵɐt24	日{日期，日頭（太陽）},馹
njau1	ȵɐu53	掫{(白)拿、提},搊{(白)拿、提}
njau3	ȵɐu55	皺{(白)皺眉頭，皺紋；～兀[ŋɛt5]兀[ŋɛt5]，皺巴巴},縐{(白)縐巴巴，縐紋}
njau4	ȵɐu21	牛{水牛，牛奶}
nje2	ȵe33	蠮{(訓)～～，細腰蜂，疑本字蟻}
nje3	ȵe55	胾{(白)～～，瘦豬肉，童語}
nje5	ȵe24	喏{唱喏},若{般若},惹{惹事，招惹}
nje6	ȵe22	偌{姓}
njen1	ȵɛn53	研{(又)}
nji3	ȵi55	兒{(白)乞～，乞丐，鬼～，小孩},毅{(又)用於人名，陳～}
nji4	ȵi21	儀{禮儀，儀式},誼{(常)俗讀，讀同宜},宜,兒{兒童，幼兒，雞兒（小雞）},儿{同兒字}
nji5	ȵi24	洱{普洱，洱海},駬,餌,鉺,邇,蟻,螘,艤,耳,珥,爾{(白)偶爾，爾後}
nji6	ȵi22	二{第二，二十},髶{髮飾},貳{貳心，貳臣},議{會議，議論，商議},誼{友誼，情誼},藝,義{義氣，意義},眲{輕視},爾{(語)遠指代詞，那},弍,咡,劓,佴{次、隨後}
njim4	ȵim21	儼{(常)俗讀，讀同嚴},髯,蚺{(書)},嚴,呥
njim5	ȵim24	䎃,苒,礹{險峻},染,广{因巖爲屋},冉,儼{儼然，儼如}
njim6	ȵim22	釅{釅茶}
njit5	ȵit24	熱
njo3	ȵo55	搓{(語)量詞，羣，球場有一～人}
njoek5	ȵœk24	堉,鵒,鬻{鬻文，賣官鬻爵},鈺,逳{行},辱,谷{(古)吐谷渾},褥,蓐,育{教育，體育},肉,縟,玉{玉石，白玉},獄,煜,溽,淯,浴,毓,欲{意欲，將欲，欲言又止},昱,慾{慾望，貪慾},峪{嘉峪關}
njoeng1	ȵœŋ53	搑{(白)給蔬菜鬆土，～菜地}
njoeng3	ȵœŋ55	髶{(白)毛髮、絲、線等蓬亂}
njon3	ȵon55	鑽{(白)用錐子等鑽，～穿窿喇}
njui4	ȵui21	緌,蕤
njui5	ȵui24	蕊,鋭,銳{尖銳，銳利},蘂{同蕊字}
njui6	ȵui22	叡,芮{姓},睿,汭,枘
njuk3	ȵok5	喐{聲也；俗字，動，本字逳},逳{(語)動，聲母演變同育字，以母讀如疑母，俗字喐}
njung3	ȵoŋ55	髶{(白)又音}
njyu4	ȵy21	愚,魚,漁
njyu5	ȵy24	語{語言}
njyu6	ȵy22	玉{(語)玉米，本字御米},語{告訴，不以語人}
njyun4	ȵyn21	䓂,言,研{研究，鑽研},揅,妍,堧
njyun5	ȵyn24	媆,阮,軟,瓀,朊{蛋白質}
njyun6	ȵyn22	䏰{(語)土～，蚯蚓}
njyut5	ȵyt24	刖,鈅{兵器},軏,玥,爇,焫{同爇字},月{月亮，月份},抈
no4	no21	儺,挪{挪動，騰挪},娜{婀娜，古讀上聲}
no6	no22	喏{嘆詞}
noek2	nœk3	搙{揉搓，～麪粉}
noek5	nœk24	傉,衄,朒,恧,忸{忸怩}
noeng1	nœŋ53	燶{俗字，焦、煳，本字𪒬},𪒬{焦、煳，俗字燶}
noeng2	nœŋ33	捅{(白)推搡，端組旁轉}
noeng4	nœŋ21	儂{儂家},齈{多涕},醲,農,膿,穠,濃,憹{㦀憹},噥
not3	not5	捺{(白)搓，～老泥},肭{(白)肥～～，胖乎乎，矮～～，形容人矮而小，與腯旁轉}
nu1	nu53	挼{同捼字，搓},捼{搓，又作挼字}
nu4	nu21	奴,駑,笯,砮{磨刀石},孥
nu5	nu24	努,胬,砮{石箭鏃},弩
nu6	nu22	怒,糯{糯米},懦
nui1	nui53	推{(白)推搡，冇～跌我，端組旁轉}
nui5	nui24	浽{溾浽},餧{同餒字},餒{凍餒，氣餒}
nui6	nui22	內
nuk3	nok5	篤{(語)重～～，沉甸甸}
nun5	nun24	暖,煖{同暖字}
nun6	nun22	嫩
nung3	noŋ55	鬞{(白)～鬤，窩囊、不整潔}
nung4	noŋ21	鬞{亂髮}
nyu5	ny24	女{女人，婦女，孫女，姪女，友女（後起詞）},釹,籹
o1	∅o53	倭{倭寇},阿{阿膠，阿彌陀佛，阿諛；阿房宮；姓},踒{踒腳},蝸,萵{萵筍，萵苣},窩,窠{(訓)訓讀窩},渦{漩渦},撾{老撾，讀同濄/渦},媧,婀,娿,妸,喔{嘆詞}
o2	∅ɔ33	䰀,倭{(古)倭墮}
o3	∅o55	哦{(語)～呵兵，戲曲中跑龍套的兵卒，又作哦嗬兵},𤆏{蒐集成堆來燒，～草},涴{污染；弄髒}
o4	∅o21	哦{表應允或醒悟}
o5	∅o24	哦{表驚奇},涴{(語)～蛋，變質蛋、散黃蛋，疑本字毈，杜果切，定母讀如匣母},毈{(又)},嚄{嘆詞}
o6	∅ɔ22	禍{禍害，災禍}
oe4	∅œ21	而{(文)而且}
oe5	∅œ24	爾{(文)}
oek2	∅œk3	偓,齷{齷齪},鋈,渥,沃,握{握手，掌握},幄,屋{房屋，屋檐，屋頂},喔{雞啼聲},剭
oeng1	∅œŋ53	㙲{同壅字},鶲,饔,雝{雝渠，雝雝；同雍字},雍{雍和，雍容},鎓,邕{邕州，邕江，邕劇},螉{蠮螉},臃,翁{老翁},癰,灉,澭,滃{滃江},壅{壅塞；埋，～肥，施肥},噰,嗡{嗡嗡},嗈,䩺
oeng2	∅œŋ33	擁{擁有，擁護；推},蓊,滃{雲氣起；大水貌}
oeng3	∅œŋ55	䐥,齆,蕹{蕹菜},罋{同甕字},甕{酒甕，入甕；～缸，水缸；量詞},瓮{罌也}
paa1	pʰa53	扒{扒鴨（一道傳統菜）},趴{趴下，馬趴},葩{(又)},舥{(又)}
paa3	pʰa55	帊,把{(語)量詞，用於女性嘴巴，渠亞～口冇識幾厲害},怕
paai3	pʰai55	哌,蒎,湃{(又)本讀},派{氣派，派送，派頭}
paan1	pʰan53	扳{通攀字},攀{高攀，攀登}
paan2	pʰan33	板{(白)手～心，手掌心，腳～心，腳掌心}
paan3	pʰan55	扳{(白)量詞，庹，兩手平伸的距離},鋬,襻{紐襻},袢{同襻字；袷袢},盼
paang1	pʰaŋ53	嗙{(語)象聲詞；詞綴，聾[lœŋ53]～～，聾得很},𩐨{鼓聲},膀{膀腫},胮{腫；〈語〉臭～～，臭烘烘，俗字亨/烹},弸{(白)量詞，庹，兩手平伸的距離}
paang3	pʰaŋ55	肨{腫脹},胖{(又)肥胖，本字肨}
paap3	pʰap5	卟{(語)搭，亞條濕毛巾～住膊頭}
paat2	pʰat3	汃{水波相激聲}
paau1	pʰau53	拋{拋開，拋棄；〈語〉兩方或幾方數量相等},脬{尿脬，卵脬；捧卵～、捧～，巴結、拍馬屁},穮{禾虛貌；〈語〉虛鬆不實，一說本字泡},泡{量詞；〈語〉虛鬆不實，本字穮，另一說本字泡；〈外〉泡打粉，英語powder}
paau2	pʰau33	跑{跑步，奔跑}
paau3	pʰau55	奅{虛大；〈語〉扯大～，吹牛，同扯大炮},雹{(訓)冰雹，訓讀泡},窌{大也},砲,皰{皰疹，水皰},疱,炮{槍炮，炮仗；炮製，炮烙，古讀平聲},泡{浸泡；氣泡；水泡（指水皰）；〈又〉泡沫}
paau5	pʰau24	泡{泡沫，肥皂泡，水泡（指泡沫）}
pai1	pʰɐi53	批{批改，批評，批發；抹，～灰，抹灰，～牆，抹牆},𠜱{削，～皮},錍,鈚{鈚箭}
pai3	pʰɐi55	俾{俾倪},睥{睥睨},埤{埤堄}
pam1	pʰɐm53	嘣{(語)象聲詞，～一聲，爆竹響喇}
pam2	pʰɐm33	品{(又)},榀{(又)}
pam4	pʰɐm21	嘣{(語)象聲詞，～一槍打中喇}
pan1	pʰɐn53	噴{(語)訓斥、罵}
pan2	pʰɐn33	品{出品，品行},榀
pan3	pʰɐn55	噴{噴水，噴嚏，噴香},濆{通噴字},湓{水聲},歕{同噴字},坌{(白)灰塵大；～塵，煙塵、灰塵}
pang1	pʰɐŋ53	亨{同烹字},烹{烹飪，烹調},泙{水聲}
pang3	pʰɐŋ55	㼞{罌屬}
pap3	pʰɐp5	卟{(語)聚攏，亞啲嘢～做一堆；搧（耳光）}
pat2	pʰɐt3	匹{一匹布，匹配；該量詞可表示件，一～事冇有，沒那麼回事},苉,疋{同匹字}
pat3	pʰɐt5	𠯔{嘆詞，～斜[tsʰe21]咧[le21]，呸}
pau2	pʰɐu33	剖,瓿,棓{躡板},掊{擊},婄
pau3	pʰɐu55	穮{(白)鬆}
pe1	pʰe53	披{(語)竹～，長條竹片},𠵿{(外)撲克，打～，打撲克，英語pair}
pe3	pʰe55	㹃{(白)撥拉，鷄崽～禾稈}
pem4	pʰɛm21	嘣{(語)象聲詞，～一槍，打中喇}
pen1	pʰɛn53	翻{(白)～草，～書}
pen2	pʰɛn33	片{(白)〈動〉片肉；〈名〉尿片}
pet3	pʰɛt5	噼{(語)穮～～，（植物子實）不飽滿或（木頭）內部不結實}
peu2	pʰɛu33	掊{(白)清除}
peu3	pʰɛu55	漂{(白)打～料[lɛu55]子，打水漂兒}
pi1	pʰi53	丕,駓,鎞{箭鏃},鈹{大針；長矛},苤,紕{紕漏；〈語〉布類表面有毛刺},砒,狓,狉,披{披掛},帔{古代戲服},呸,伾
pi2	pʰi33	仳,鄙,痞{痞子，地痞},彼{(又)},庀,圮,嚭,否{否極泰來},吡{詆毀},佊{(又)}
pi3	pʰi55	媲{媲美},譬{譬如，譬喻},濞,淠{淠河},帔{霞帔},屁,嬖
piak2	pʰiɐk3	啪{象聲詞，噼啪},𢫦{同拍字},魄{魂魄，氣魄},迫{強迫，迫害，迫擊炮},袙,蘗{(白)},舶{(白)},粕{(白)糟粕},珀,泊{(白)湖泊，梁山泊；泊船，停泊},檗{(白)黃檗，又作黃柏},柏{(白)柏樹，松柏},拍{拍照，節拍},帕{手帕，帕斯卡，讀同拍},岶
piang1	pʰiɐŋ53	牓{(白)門～，門框兩側，貼對聯用}
pik2	pʰek3	僻,鸊,鷿,霹,闢{開闢，精闢},釽,辟{復辟，辟邪},癖,甓,澼,擗,揊{擊聲},噼{象聲詞，噼啪},劈{劈開；～酒，豪飲}
pin1	pʰin53	偏,蹁{蹁躚},翩,編{編寫，郵編},篇{篇章，詩篇},犏,煸,揙,扁{扁舟；扁桃樹/果，又作偏字}
pin3	pʰin55	片{一片，藥片},騙{騙馬；欺騙},遍{一遍，遍地}
ping1	pʰeŋ53	伻,閛,砰,砯,甹,淜{淜滂},涄,拼{(又)},抨{抨擊，抨彈},怦,娉{娉婷},匉,俜
ping3	pʰeŋ55	姘{姘頭，讀同拼},聘,拼{拼湊，拼合；拼命，打拼},娉{同聘字，定婚}
pit2	pʰit3	䥕,瞥,氕,撇{撇捺；撇開},嫳
piu1	pʰiu53	嘌{疾速},飄,螵,縹{縹緲},漂{漂浮},摽{擊}
piu2	pʰiu33	瞟,縹{青白色；青白色絹}
piu3	pʰiu55	嘌{嘌呤},驃{驃勇},票{車票},漂{漂白；漂亮}
po1	pʰo53	坡,陂{陂陀},科{(白)量詞，用於植物，後作棵},樖{(量)粵字，棵、株，本字科},棵{(語)量詞，本字科，俗字樖}
po2	pʰo33	叵{不可的合音，叵測，叵耐},頗{頗有，頗爲；偏頗},鉕,笸{笸籮}
poek2	pʰœk3	仆{(白)趴，～住睡；～落歸，掉下來；～～趢[lœk3]趢[lœk3]，踉踉蹌蹌；翻來～去，翻來覆去}
poeng1	pʰœŋ53	蓬{(白)白～～，雪白},逢{(白)撲，與撲對轉}
poeng2	pʰœŋ33	捧{捧場，吹捧；～卵脬、～脬，巴結、拍馬屁}
poeng3	pʰœŋ55	椪,踫{同碰字},碰
pu1	pʰu53	潽{液體沸騰溢出，本字𩱚},鋪{鋪設},舖{同鋪字}
pu2	pʰu33	哺{哺育},黼,鐠,輔{輔助，輔導},譜,脯{果脯},甫{杜甫，台甫，驚魂甫定},潽{水名},溥,浦,氆,普,捕{逮捕，捕捉},埔{柬埔寨},圃
pu3	pʰu55	破,鋪{店鋪},舖{同鋪字},簸{〈名〉簸箕；〈動〉簸米}
pui1	pʰui53	㾦{㾦㿔},醅,衃{瘀血},胚{胚胎},垺{製陶模型；大},坯{土坯},坏{同坯字}
pui3	pʰui55	㾦{痂也},霈,配,茇{白色的凌霄花},琲,珮{同佩字，玉珮},沛,旆,佩{佩服，玉佩}
puk2	pʰok3	仆{仆倒，前仆後繼},鏷,釙,醭{醋生白醭},轐,蹼,蒪{蒪苴},粕{(文)},穙{穀積也},瞨,璞,猼{同蒪字},烞,瀑{瀑布},濮,樸{樸素，純樸},朴{朴樹；朴刀},曝{曝曬，曝光},暴{曬，後作曝},撲{撲滅，反撲},扑,墣,噗,卟{卟吩},卜{占卜，卜卦},僕{僕人，奴僕}
pun1	pʰun53	潘{姓},番{番禺}
pun3	pʰun55	判,泮{泮宮，入泮},拚{拚命},拌{捨棄},叛{背叛，叛徒}
put2	pʰut3	潑{潑水，打潑，活潑},鏺,醱{再釀酒}
saa1	ʃa53	㸺{母牛},鯊,裟,莎{莎士比亞},紗{紗布，棉紗},砂{砂糖，朱砂；同沙字},痧{刮痧，發痧},沙{泥沙，沙漠；～牛，黃牛；～塵，輕浮、驕傲，～塵白醭，比喻人辦事輕浮、不牢靠},挲{挓挲；摩挲（按着移動）},唦{象聲詞；語氣詞}
saa2	ʃa33	啥{什麼},耍{戲耍，耍把戲},廈{旁屋；地名，四廈嶺}
saa3	ʃa55	嗄{聲音嘶啞}
saai3	ʃai55	塞{邊塞，塞外},賽{比賽，賽跑},殺{減削也；衰也},曬{曬乾，暴曬，曬臺（陽臺）},晒{同曬字}
saai4	ʃai21	喍,柴{柴火，木柴}
saai5	ʃai24	摋{抖擻},𧜁{襰𧜁，衣破貌},甩{甩手、扔，本字摋}
saak2	ʃak3	索{(白)又音，量詞}
saam1	ʃam53	摻{摻摻},釤{金屬元素，符號Sm；姓},衫,芟,穇{稴穇}
saam3	ʃam55	釤{釤鐮，釤草}
saan1	ʃan53	刪,閂{門閂，閂門},跚,舢{舢舨，舢板},珊,潸,栓{消防栓，栓劑},柵{柵極},拴{拴住},山,姍
saan3	ʃan55	汕,赸,訕{訕笑，搭訕},疝{疝氣},涮{涮洗}
saan4	ʃan21	僝{僝僽},潺,漦{(白)唾液},涎{(語)唾液，本字漦},孱{孱弱}
saan6	ʃan22	棧{(白)碗～，碗櫃}
saang2	ʃaŋ33	塽,爽
saang4	ʃaŋ21	床{同牀字},牀{牀鋪，河牀}
saap2	ʃap3	霅{散也；～氣，傷腦筋；～眼，超出一般，俗字霎},霎{(語)～氣，傷腦筋，本字霅，散也；～眼，超出一般，疑本字㵤，溢也}
saap6	ʃap2	渫{水名；同煠字，用水熬煮},煠{用水熬煮，又作渫字}
saat2	ʃat3	刷{刷白},鎩,脎,煞{惡煞，煞尾，煞費苦心},殺{殺敵，謀殺},摋{雜糅},剎{同刹字},刹{刹車，刹那，古刹}
saat6	ʃat2	䶡{咬物聲}
saau1	ʃau53	捎{捎帶，捎信；〈語〉用手橫掃抓住},鞘{鞭鞘},蛸{蠨蛸},艄,筲{筲箕，斗筲},稍{稍後，稍微（口語用稍爲）},梢{樹梢，眉梢}
saau2	ʃau33	稍{(又)𥹉[nɐp24]～，不利索、動作慢}
saau3	ʃau55	哨{哨兵，放哨，口哨；～牙，齙牙},睄{小視},潲{豬潲；潲雨}
saau4	ʃau21	睄{(白)又音}
sai1	ʃɐi53	師,鶳{鳥名；大雀名},鳾{同鶳字},鰤,釃{濾（酒）；斟（酒）},襹,褷,螄,簁,篩{篩子，篩選；〈語〉斟，～酒，本字釃},獅{獅子，舞獅},溮
sai2	ʃɐi33	使{使用，好使；出使，使者},駛,史{歷史}
sai4	ʃɐi21	㩄{(語)詞綴，笑～～，笑吟吟}
sai5	ʃɐi24	媞{(白)～草，莎草、香附}
sai6	ʃɐi22	事,涘,柿{柿子，柿餅},士{士兵，護士},俟{俟機},侍{服侍，侍衛，讀同事},仕
sam1	ʃɐm53	參{人參},鰺,郴,蔘,綝,琛,深,棽{(又)},森
sam2	ʃɐm33	嬸,邥,讅,諗{諗知，諗悉},瞫{竊視},瀋{瀋陽市},淰{魚駭貌},沈{姓},審
sam3	ʃɐm55	沁{沁人心脾},瞫{(白)偷看；細看；東張西望},瘮,滲{(文)}
sam4	ʃɐm21	忱,諶{信也；誠也；姓},蟾{蟾酥，蟾蜍（口語稱蠄蟝）},煁,沉{(語)眯[mɐi55]～～，眼眯打瞌睡，本字沈},沈{(語)眯[mɐi55]～～，眼眯打瞌睡，又作沉字}
sam5	ʃɐm24	椹{同葚字},葚{桑葚}
sam6	ʃɐm22	什{什麼，同甚麼},黮{通葚字},甚{甚至；甚麼}
san1	ʃɐn53	伸{延伸，伸展},身{全身，身體},紳,神{神荼},砷,申,珅,呻{呻吟}
san3	ʃɐn55	呻{(語)訴苦，～窮，哭窮},瞬
san4	ʃɐn21	唇{同脣字},錞{錞于，古樂器},鉮,醇{醇香，醇厚},辰{星辰，時辰},蓴{蓴菜},蒓{蒓菜},脣{口脣，脣齒},純{純粹，單純},神{精神，神聖},淳,晨,宸,娠
san5	ʃɐn24	吮,雋{雋永},蜃,腎,脤{生肉；（芋頭等薯類）脆而不麪、不粉；（人）不機靈，～崽},肫{(訓)訓讀腎},楯{欄杆}
san6	ʃɐn22	慎,順,舜,胂{有機化合物},昚
sang5	ʃɐŋ24	上{動詞，上山},鞝{鞝鞋，同緔鞋},緔{緔鞋，即上鞋}
sang6	ʃɐŋ22	上{方位詞，上面},尚{高尚，尚且，和尚}
sap2	ʃɐp3	溼{潮溼，溼潤；豬～，豬肝，避諱肝/乾},鈒{戟},譅,濕{同溼字},澀{羞澀，晦澀，苦澀（形容心情）}
sap6	ʃɐp2	什{什錦，什物},辻{日本漢字，讀同十},拾{拾取},十{十足，第十；弱讀爲[a22]，二十、三十、四十分別記作廿、卅、卌}
sat2	ʃɐt3	失{失去，丟失},鯴,蝨{蝨子（口語單用蝨），跳蝨（跳蚤），狗蝨（狗身上的跳蚤）},虱{同蝨字},室
sat6	ʃɐt2	實{真實，老實；白～～，慘白}
sau1	ʃɐu53	嗖{象聲詞},溲,收{豐收，收入},廋
sau2	ʃɐu33	守{守衛；太守，古讀去聲},首{首先；自首},艏,手{上肢；豬手（豬前腿）；量詞，一手}
sau3	ʃɐu55	狩,瘦,獸
sau4	ʃɐu21	仇{仇敵，恩仇},愁
sau6	ʃɐu22	受,綬,授,壽,售
se1	ʃe53	奢{奢侈},賒,畲{畲族},畬{燒草耕田；畬族，今作畲；姓}
se2	ʃe33	捨{捨棄，捨得},舍{同捨字}
se3	ʃe55	厙,騇{母馬；嫖～，嫖妓，俗作嫖舍},赦,舍{宿舍，校舍},猞
se4	ʃe21	佘{姓},闍{闍黎},蛇{毒蛇，蛇行；〈語〉形容詞，懶},虵{同蛇字}
se5	ʃe24	社
se6	ʃe22	射{射箭},麝{麝香}
sen1	ʃɛn53	搧{(白)搧一巴掌；搧火}
sep6	ʃɛp2	霅{(語)詞綴，溼～～，溼淋淋，本字霫},霫{(白)詞綴，溼～～，溼淋淋，俗字霅}
set2	ʃɛt3	失{(白)忔[ŋɛt3]～，吝嗇}
si1	ʃi53	尸{尸位素餐},鸍,鳲,邿,賒{(白)},詩{唐詩，詩詞},蓍,葹,絁{粗綢},畬{(白)畬地},施,屍{屍骨，死屍}
si2	ʃi33	始{開始，始終},豕{豬也},矢{飛矢，矢志；通屎字},屎{屎尿；〈語〉差勁、水平低}
si3	ʃi55	世,逝,貰,謚{同諡字},諡{諡號},誓,試{考試，試卷，試驗},舍{(白)隔籬鄰舍},筮,澨,弒{同弑字},弑{弑君，篡弑},噬{吞噬，反噬},嗜,勢{勢力，形勢},僿
si4	ʃi21	匙{鎖匙，鑰匙；飯～骨，肩胛骨},鼭,鰣{鰣魚},蒔{蒔蘿},榯,時,姼{姼母也；美女},塒
si5	ʃi24	市{菜市，市場},鈰
si6	ʃi22	䏡,𩛌{嗜食},豉{豆豉，豉油},諟,視,褆{衣服端正貌},蒔{蒔秧},舐{舐犢},示,氏{姓氏，氏族},昰,是{是否，於是；冇～，不然；～但，隨便},恃{恃才傲物，有恃無恐},忯{恃也},市{(語)利～，紅包},峙{繁峙縣},媞{諦也},士{(外)的～，出租車，英語taxi；巴～，公共汽車，英語bus}
siak2	ʃiɐk3	愬{驚懼貌},鑠,索{(白)量詞，邊、塊、片，兩～，兩片，肋～骨，肋骨，索字古有量詞義，俗字𤖴/析/𢱢},粣{糝也},爍{閃爍，鑠金},溹{溹溹},洓,槭{葉落貌},摵{捎；同槭字；〈語〉～飯，指菜開胃、下飯}
siak6	ʃiɐk2	勺{湯勺，勺子},芍{(又)},杓{杯杓}
siang1	ʃiɐŋ53	傷,觴,胜{餼肉；肽的舊稱},笙,甥{外甥（姐妹之子；外孫），外甥女（姐妹之女；外孫女）},生{生活，學生},牲,熵,湯{(古)浩浩湯湯},殤,墒,商
siang2	ʃiɐŋ33	晌{(又)},餉{(又)},賞,眚,省{節省，省份}
siang3	ʃiɐŋ55	鋥{(又)}
siang4	ʃiɐŋ21	倘{倘佯，同徜徉},鱨,裳{衣裳},徜{徜徉},常{經常，常識；姓},嫦,嚐{品嚐，飽嚐},嘗{嘗試，何嘗},償{賠償，償還}
sik2	ʃek3	嗇{吝嗇},骰{(訓)訓讀色；坊間戲稱骰王爲色魔},飾,銫,釋{釋放，解釋},適,适{同適字},軾,識{知識，識別},襫,螫{蟲行毒},色{顏色，色澤（口語稱色水）；色子（骰子），打～，擲色子，引申爲做莊、做東},穡,栻,拭,式,奭
sik6	ʃek2	炻,鼫,食{糧食，食物},蝕{腐蝕，日蝕},祏,碩,石{石頭，岩石；十斗，不從官話之訓讀擔去聲}
sim1	ʃim53	苫{(名)草苫子}
sim2	ʃim33	䀹,陝{陝西},閃,睒,晱
sim3	ʃim55	掞{舒展},苫{(動)遮蓋}
sim4	ʃim21	單{單于},蟬,禪{禪宗，禪師},嬋
sim6	ʃim22	剡{剡溪},贍
sin1	ʃin53	埏{揉和},膻{膻味},羶{羶味},烻{光},搧{搧耳光，搧巴掌，搧人；〈又〉搧動，～擛[jap2]擛[jap2]，來回搧動},挻{柔也；取也}
sin3	ʃin55	䥇,騸{騸馬，騸狗},釤{(又)俗字䥇},煽{煽動，煽風點火},搧{搧動，搧風，搧扇子；〈語〉甩出去、滑倒},扇{扇子，風扇，一扇門}
sin4	ʃin21	儃{儃徊},澶{澶淵}
sing1	ʃeŋ53	升{升級，上升，一升},陞{姓},聲{聲音，笑聲},昇{畢昇；旭日東昇},塍{(又)}
sing3	ʃeŋ55	勝{勝利；勝任，古讀平聲；通～，皇曆、曆書，避諱書/輸},蟶{(常)讀同聖},胜{同勝字},聖,圣{同聖字}
sing4	ʃeŋ21	丞,𡷫,鋮,郕,誠,繩,盛{盛滿},珹,澠{古水名},椉{同乘字},晟,承,成{完成，成功；成數，幾成},宬,塍{田塍},城{城市，出城},乘{乘坐}
sing6	ʃeŋ22	乘{千乘},賸,盛{旺盛；姓},椉{同乘字},嵊,剩{剩餘，剩下}
sip2	ʃip3	䀹{(又)},灄,涉,歙{地名，歙縣（在安徽）},攝,懾
sit6	ʃit2	揲{揲蓍},鞨{治革},舌
siu1	ʃiu53	燒{發燒，燒鵝}
siu2	ʃiu33	少{多少}
siu3	ʃiu55	少{少年}
siu4	ʃiu21	柖,韶{韶華，韶光},苕{紅苕},玿
siu6	ʃiu22	劭,鮡{(又)},邵,肇,紹,召{姓；周朝國名}
slaa1	ɬa53	卅{三十，三啊[a22]的合音，啊[a22]爲十的弱讀，口語作[ɬa53a22]}
slaa2	ɬa33	洒{同灑字},灑{灑水}
slaa4	ɬa21	查{(白)麻～，黃昏；案，元曲作麻查，唐宋作麻茶，皆表模糊、迷蒙貌},灑{(語)詞綴，落雨～～，雨淅瀝貌，亂～～，雜亂，疑本字查}
slaai1	ɬai53	㩄{浪費；一兩歲小兒死亡，俗字嘥},鰓,顋,諰{～譡[taŋ55]，奚落諷刺人},腮{腮幫，面腮；～巴，腮幫子},毸{毰毸},揌{擡揌},愢,思{于思},嘥{俗字，浪費；一兩歲小兒死亡，本字㩄}
slaai3	ɬai55	嗮{粵字，表完全、全部，一說本字澌/㩄/煞/殺，本地用齊}
slaak2	ɬak3	揱,蒴,索{繩索；求索，古讀山責切、山戟切},箾{以竿擊人；舞者竿},溹{溹河},洬{大風雨貌},槊,朔{朔月，朔方},搠
slaak3	ɬak5	㩇{(訓)裂開、折斷，褲𧟘～喇，褲襠裂了}
slaak6	ɬak2	泎{(白)潑、灑，米～出來喇}
slaam1	ɬam53	三{三個；三思，古讀去聲；～點頭、～點、～星公、～星高照，猜碼口令，數字三},毿,弎,叁,仨
slaam2	ɬam33	糝{(名)粉末，退熱～}
slaam4	ɬam21	讒{(白)讒言},饞{(白)嘴饞}
slaan2	ɬan33	散{鬆散，散彈槍；～紙/錢，零錢},饊{米花糰},糤{同饊字}
slaan3	ɬan55	傘{傘兵，雨傘},鏾{弩},潵{水散也},散{解散，分散}
slaang1	ɬaŋ53	喪{喪事},𦅇{淺黃},桑,嗓{嗓子，嗓音，讀同桑}
slaang2	ɬaŋ33	嗓{(又)本讀},顙,磉{柱下石},搡{推搡；〈語〉掙扎}
slaang3	ɬaŋ55	䒏{(白)䒐[maŋ55]䒐[maŋ55]～～，隨隨便便、不正經},𦅇{(又)},喪{喪失}
slaang5	ɬaŋ24	㨘{(又)}
slaap2	ɬap3	唼{唼喋},𥈊{理睬，搭～，搭理},𢶍{擸𢶍，又作垃圾},𠿓{醜；食貌},馺{馬行疾；〈語〉地～，地鱉},颯{颯颯，颯爽},靸{小兒履},霎{霎時，一霎那},霅{雨雹下貌},鎝{鏤},鈒{鈒鏤},趿{進足},歃{歃血},圾{垃圾，本字擸𢶍},喢{多言；～戇[ŋaŋ55]，傻瓜、言行無道理；（狗）兇，渠門口有隻狗～唅[hɐm21]唅[hɐm21]}
slaap6	ɬap2	喋{(白)～得，食欲好、能吃}
slaat2	ɬat3	摋{側手擊},躠{跋躠},薩{菩薩，拉薩；姓},潵{潵河},攃{象聲詞；同撒字},撒{撒手，撒種}
slaat3	ɬat5	攃{(語)象聲詞，褲𧟘～喇，褲襠撕裂了}
slaat6	ɬat2	躠{(語)澀[kip3]～～，很澀}
slaau1	ɬau53	搔,鰠,騷{風騷，騷動；縮～，退縮、打退堂鼓},颾{風聲},臊{臊味，腥臊；～甲，蟑螂，古稱蜚，臭蟲也},繰{同繅字},繅,溞
slaau2	ɬau33	䕅,嫂
slaau3	ɬau55	埽,臊{害臊},瘙,掃{掃地；掃把}
slaau4	ɬau21	捎{(白)揍、打，～一巴掌；很能吃，～得過癮，吃得過癮},睄{(白)掃視}
slai1	ɬɐi53	恓,西,荽{(習)芫荽},茜{用於人名},舾,粞,硒,犀,樨
slai2	ɬɐi33	屣{鞋},躧,蹝{同屣字},諰{恐懼},蓰,葸,纚{冠織也},縰,璽{玉璽},洗,洒{同洗字},枲,徙
slai3	ɬɐi55	壻{女壻，夫壻},細,婿{同壻字}
slai4	ɬɐi21	摋{(語)揍、打},齊{(語)眼眯[mɐi55]～～，眼睏、眼皮眯成縫}
slak2	ɬɐk3	噻{噻吩，噻唑},揌{通塞字},息{(白)孫～，重孫，女～，重孫女，上古職部，俗字塞},塞{塞車，堵塞}
slak6	ɬɐk2	噻{(語)形容詞後綴，醒～，精神，默[mɐk2]～，死亡}
slam1	ɬɐm53	心,芯
slam2	ɬɐm33	伈,糝{(動)撒，～啲灰、～啲古月粉}
slam4	ɬɐm21	尋{(白)傻、呆，尋者尋常也；詞綴，亂～～，雜亂}
slan1	ɬɐn53	侁,駪,鋅,辛,詵,薪,莘,甡,燊,新,屾
slan2	ɬɐn33	栒{栒虡},隼{(又)本讀},筍,笋{同筍字},榫{榫頭，榫眼}
slan3	ɬɐn55	信,迅,訊,蕈{香蕈，俗作香信},濬{濬河，濬縣},浚{浚河，浚縣},汛,囟{囟門，囟骨}
slan4	ɬɐn21	侚,馴{馴養，馴服},郇{周朝國名},詢,荀,紃,珣,洵,殉,栒{木名},旬{上旬，八旬},揗{撫摩；順從},恂{恐懼貌；〈語〉發抖，～邪[ɬe21]邪[ɬe21]，發抖貌},循,徇,巡{巡視，出巡},峋
slang1	ɬɐŋ53	僧{(又)}
slang3	ɬɐŋ55	擤{擤鼻涕}
slang4	ɬɐŋ21	䁬{(白)詞綴，懵～～，糊糊塗塗},鬙{(語)鬅[pɐŋ21]～倰[lɐŋ21]，不整潔}
slang5	ɬɐŋ24	㨘{俗字，擦拭，疑本字鋥；訓斥、搶白；打}
slap2	ɬɐp3	㿇{小痛}
slap3	ɬɐp5	圾{(白)～碎，瑣碎、零碎，本字𢶍},𢶍{(白)～碎，瑣碎、零碎},𠿓{(白)吸食，～粥，喝粥}
slap6	ɬɐp2	趿{(語)動作慢、遲鈍，渠做事情手腳～一世，一件事做幾耐},霫{(白)詞綴，爛～～，衣服破爛貌，俗字霅},霅{(語)詞綴，爛～～，衣服破爛貌，本字霫}
slat2	ɬɐt3	卹{撫卹},銊,裇{英語shirt的音譯，現多用恤字},蟋{蟋蟀[tʃɐt3]},膝{膝蓋，促膝；～頭、～頭蓋、～頭尖，膝蓋},窸,窣,璱,瑟{琴瑟，瑟縮},率{率領},摔{摔手，摔打，摔倒，摔跤},戌{戊戌，戌時},悉{熟悉，悉心},恤{體恤}
slat6	ɬɐt2	沭,鉥,述,術{技術，術語},秫
slau1	ɬɐu53	䗛,饈,餿{飯餿，餿水},颾{同颼字},颼{冷颼颼},鄋,蒐{草名；春獵；蒐集，蒐羅},脩,羞,修
slau2	ɬɐu33	叟,鎪,謏{謏訹},螋,藪,艘,瞍,滫,擻{抖擻},搜{搜查，搜索},嗾{嗾使}
slau3	ɬɐu55	嗽{咳嗽},鏽{鐵鏽，不鏽鋼},銹{同鏽字},繡{繡花，刺繡},綉{同繡字},秀,琇,宿{星宿，舊時俗讀住宿之宿}
sle1	ɬe53	些{一些，些少},罟{(語)又音，俗字⿰糹些；案，民族語對音中有[r-/ɵ-]自由變體}
sle2	ɬe33	寫
sle3	ɬe55	卌{四十，四啊[a22]的合音，啊[a22]爲十的弱讀，口語作[ɬi55a22]},瀉{傾瀉，瀉藥},卸
sle4	ɬe21	斜{(白)乜[me21]～，醉態},邪{驅邪，邪惡}
slek3	ɬɛk5	惜{(白)珍惜（物）；疼愛（人）}
slen3	ɬɛn55	峻{(白)璺[mɛn55]～，邊緣；勉強}
slen4	ɬɛn21	殘{(白)刺兒刺入肉裏的感覺}
slep2	ɬɛp3	𤗈{(白)小楔；墊，用楔子嵌穩，～平檯腳，墊平桌腳}
slep6	ɬɛp2	喋{(白)鴨吃東西，鴨崽～浮薸},趿{(語)拖～鞋，拖鞋；詞綴，拖～～，趿拉，慢～～，行動慢}
slet3	ɬɛt5	攃{(語)劃破，手指～喇}
slet6	ɬɛt2	截{(白)表少量，一～鹽、一～油}
sli1	ɬi53	㟃,𥯨,鼶,鷥,颸,鍶,蟴,蜤{蜤螽},虒,罳,緦,絲{蛛絲，絲綢},糸{同絲字},私{自私，私心，家私（家具）},禠,禗,磃{磃氏},澌{盡也},榹,楒,斯,撕{撕開，撕破},思{思念；意思，古讀去聲},廝,噝,嘶{嘶鳴，嘶叫，古讀先稽切},司,厶{私的古字；部首},凘,偲{偲偲},俬{傢俬，同家私（家具）}
sli2	ɬi33	徙{(又)},璽{(又)},死
sli3	ɬi55	四{第四，四海；～季發財、～季來財、～紅四、～紅，猜碼口令，數字四},駟,蕼,肆{四字的大寫；放肆},肂,泗,柶
sliak2	ɬiɐk3	削{削皮，剝削}
sliang1	ɬiɐŋ53	儴{儴佯},驤,鑲,襄,葙,纕,緗,箱,相{互相，相反},瓖,湘,廂,勷{同襄字}
sliang2	ɬiɐŋ33	想,鯗{魚乾},鮝{同鯗字}
sliang3	ɬiɐŋ55	相{相貌，相片；假～，做作、假正經；小～，小氣；老～，長得顯老}
slik2	ɬek3	媳{婆媳，媳婦},錫,裼{袒裼},螅,蜥,蜤{蜤蜴，即蜥蝪},蒠,菥,舄,腊{乾肉},皙{白皙；白～～，（人）白淨},瘜,熄,潟,淅,棤,析,晰,昔,惜{可惜},息{休息，息怒；滴～，小巧}
slin1	ɬin53	䙴{升高也；（稱物時）秤尾高，～啲，升高點，俗字先},酰,躚{(又)本讀},褼,秈,氙,先{先後，祖先；句末虛詞，你行～、等渠來～；〈語〉（稱物時）秤尾高，本字䙴},僊{同仙字},仙
slin2	ɬin33	冼,銑,跣,筅,燹
slin3	ɬin55	䤼,霰{雨霰，雪霰；霰彈（口語稱散[ɬan33]彈）},腺,羨{羨慕，豔羨},羡,線{針線，線條；姓},綫{同線字}
sling1	ɬeŋ53	惺,騂,腥{腥臭，魚腥草},瑆,猩,煋,星{流星，天星}
sling2	ɬeŋ33	省{反省，省悟},醒{醒目，睡醒},箵
sling3	ɬeŋ55	姓,鍟{同鉎字},鉎{鐵鏽，又作鍟字},性
slip2	ɬip3	躞,𤗈{(文)}
slit2	ɬit3	偰,榍,楔{楔子},揳{塞},屑{不屑；木屑}
sliu1	ɬiu53	㩋{把},魈,霄,銷,逍,蠨,蛸{螵蛸},蕭,肖{姓，蕭的俗字},翛,綃,簫,箾{箾韶},硝,瀟,消,梢{(又)讀同銷/消},揱{(又)},捎{(又)讀同銷/消},宵
sliu2	ɬiu33	小,謏{謏聞},篠,筱
sliu3	ɬiu55	咲,笑,嘯
slo1	ɬo53	唆{囉唆，唆使，教唆},趖,蓑{蓑衣，蓑草},莎{莎草},羧,簑,睃,梭{織布梭，穿梭},桫,挲{摩挲（撫摩）},娑{婆娑，摩娑},嗦{哆嗦；囉嗦，同囉唆}
slo2	ɬo33	所
slo4	ɬo21	傻,梭{(語)簸[po21]～邏，樹冠覆蓋面大，遮陽好}
slo6	ɬo22	乍{(語)量詞，一小陣，啱先落了一～雨}
sloek2	ɬœk3	㩋{擊},鷫,驌,餿{(訓)食物過宿，訓讀宿},蓿,肅{嚴肅，肅立},粟{粟米，罌粟},洬{洬洬},宿{住宿，一宿；餿、酸臭，俗字餿；〈舊〉星宿，俗讀},夙,僳
sloek6	ɬœk2	俗{風俗，俗世}
sloeng1	ɬœŋ53	倯,鬆{放鬆},菘,淞,松{(常)松樹，松子，松香},忪{惺忪},嵩,崧,娀,凇
sloeng2	ɬœŋ33	㩳,聳{聳立，高聳；〈語〉骨～，骨灰（或骨殖）罈子},竦,慫{慫恿},悚
sloeng3	ɬœŋ55	宋,餸{下飯的菜，本字送},送{贈送，送別；〈語〉下飯的菜，俗字餸}
sloeng4	ɬœŋ21	㞞{俗字，～～邪邪，無精打采，本字倯，因聲旁松轉讀邪母},倯{(白)～～邪邪，無精打采，因聲旁松轉讀邪母，俗字㞞}
slot6	ɬot2	啐{(語)象聲詞，吃麪條吃得～～聲}
slu1	ɬu53	囌{嚕囌},鬚{鬍鬚，鬚根},酥{酥油，酥脆},蘇{紫蘇；姓},穌,甦{甦醒，復甦}
slu2	ɬu33	嗩,鎖,璅{同瑣字},瑣{瑣碎，繁瑣},惢
slu3	ɬu55	傃,遡,訴,膆{同嗉字},素,漱{漱口},溯{追溯},泝,愬{同訴字},愫,塑{塑像，塑料},嗉{嗉囊，嗉子}
slu4	ɬu21	擻{(白)詞綴，落雨～～，雨唰唰地下；散～～，鬆散貌；案，韻母演變同漱字，元曲作簌簌},簌{(語)詞綴，落雨～～，雨唰唰地下；散～～，鬆散貌；本字擻，簌簌爲元曲寫法}
slui1	ɬui53	浽{浽溦（小雨）；〈語〉溾浽（污穢、骯髒），又作渨涹},雖{雖然，雖說},葰{廉薑},荽{(書)},綏{綏靖，扶綏縣},睢,眭{姓},濉
slui3	ɬui55	歲,誶,祟{作祟，鬼鬼祟祟（口語稱鬼頭鬼鼠/腦、鼠頭鼠腦）},碎
slui6	ɬui22	䡵,隧{隧道},鐩,邃{深邃，邃古},遂{順遂},襚,蔧{王蔧},繐{帽繐},穟,穗{穀穗},璲,燧,旞
sluk3	ɬok5	洬{(語)象聲詞，落雨～～，唰唰地下着雨},簇{(語)詞綴，新～～，很新、簇新，讀同心母的簌}
slun1	ɬun53	孫,飧,酸{酸味},蓀,痠{痠痛},猻,狻
slun2	ɬun33	損{損失，破損}
slun3	ɬun55	噀,遜,蒜,算,筭,巽
slyu1	ɬy53	嬃,鬚{(又)},須{必須，須臾},需,諝,胥,繻,綏{(又)語流音變},湑{水名}
slyu2	ɬy33	湑{濾酒去渣},醑,糈
slyu3	ɬy55	嗉{(語)雞嗉},膆{(語)雞膆},緒{情緒，緒論},絮
slyun1	ɬyn53	喧{(又)讀同宣},鮮{新鮮；鮮卑},瑄,渲{(又)讀同宣},揎,愃,悛,宣
slyun2	ɬyn33	尟,鮮{鮮少；朝鮮，古讀平聲},選,蘚,禒,癬{腳癬，皮癬},獮
slyun3	ɬyn55	渲{渲染},鏾{～雞，閹雞（名詞），又作線字}
slyun4	ɬyn21	䃠,鏇{鏇牀},璿,璇,漩,暶,旋{旋轉；旋風}
slyut2	ɬyt3	契{商之祖},𤫉,鱈,雪{冰雪，雪白},躠{蹩躠},褻,薛{姓},紲,禼,燮,渫{除去；泄；姓},洩{同泄字},泄{泄漏，發泄},媟
so4	ʃo21	梭{(白)～～聲，下雨聲，擻/簌[ɬu21]的音變，梭梭爲元曲寫法}
soek2	ʃœk3	倏,蹜,謖{謖謖，馬謖},縮{縮短，退縮；～騷，退縮、打退堂鼓},淑{(又)},叔,儵
soek6	ʃœk2	塾,贖,蜀{蜀國，蜀道},菽,熟{煮熟},淑{賢淑，淑女},屬{屬於，家屬},孰,婌
su1	ʃu53	梳{梳頭},蔬,疏{疏遠，稀疏},疋{足也}
su2	ʃu33	數{(動)數一數}
su3	ʃu55	數{(名)數目},疏{註疏，上疏，俗讀稀疏之疏}
sui1	ʃui53	摔{(又)摔倒，摔跤},衰{衰老，衰落；倒楣}
sui2	ʃui33	嶲{同巂字},髓,瀡,水{清水，水平；錢的喻稱，一撇～，一千元（千字頭一筆爲撇，故稱），一方～，一萬元（方與萬的簡化字万形近，故稱）},巂{越巂（在四川）}
sui3	ʃui55	帥{元帥，帥印；帥氣},說{遊說，說服，俗讀說話之說},税,稅,涗,挩{擦拭},帨
sui4	ʃui21	倕,陲,誰,垂{垂直，下垂},圌{圌山}
sui6	ʃui22	䡵{(又)},隧{(又)},鐩{(又)},邃{(又)},遂{(又)},襚{(又)},繐{(又)},穟{(又)},穗{(又)},睡,璲{(又)},瑞{祥瑞，瑞雪},燧{(又)},旞{(又)}
suk2	ʃok3	嗍{俗字，吮吸，本字欶},欶{吮吸，～田螺，吸田螺，～粉，吸毒，俗字嗍},數{數見不鮮}
sung1	ʃoŋ53	孀,鸘,鷞,驦,騻,霜,雙{一雙；雙生},礵,瀧{瀧水，瀧岡}
syu1	ʃy53	姝{(又)},鄃,輸{輸贏；運輸},荼{神荼},舒,紓,毹{氍毹},樞,樗,書,攄,摴,抒
syu2	ʃy33	暑,鼠,黍,癙
syu3	ʃy55	嗾{(語)唆使、挑撥，分音作射豬，又作𡂡字},腧,戍{戍守，衛戍},恕,庶
syu4	ʃy21	噓{嘆詞，表制止},陎,蜍{蟾蜍（口語稱蠄蟝）},藷{通薯字},薯{番薯，馬鈴薯，本字藷},糬,殳,殊
syu5	ʃy24	墅{別墅},署{署名，專署},曙
syu6	ʃy22	樹,豎{橫豎，豎琴},裋,澍
syun4	ʃyn21	舡,船
syun5	ʃyn24	鱔{鱔魚，黃鱔，白鱔}
syun6	ʃyn22	倩{倩影，倩裝；請，古讀七政切},饍{同膳字},鄯,蟺{蟺蜎，蜿蟺},蟮{蛐蟮},蒨,茜{茜草},膳{膳食，藥膳},腨,繕,綪{赤繒；青赤色},箐{竹木叢生的山谷},禪{禪讓，禪位，俗讀禪宗之禪},擅,撣{撣族},嬗,墡,墠,單{姓},善,儃{同禪字}
syut2	ʃyt3	說{說話，小說}
syut6	ʃyt2	折{折本，折抵（吃虧）}
taa1	tʰa53	他,鉈{金屬元素，符號Tl},祂,牠,拖{(白)拖、拉，老木斗犁禁得～，比喻人老但禁得熬},怹{他的敬稱},它,她
taai1	tʰai53	呔{(外)車～，車胎，英語tyre},𧘹{(外)領～，領帶，英語tie，罕用，多數用領帶},苔{舌苔},胎{胎兒，懷胎}
taai2	tʰai33	㘆{語不正},呔{語不正，本字㘆}
taai3	tʰai55	傣{(又)本讀},鈦,酞,貸{貸款，借貸},肽,泰,汰,汏{同汰字},態,太
taak2	tʰak3	侂,魠,魄{落魄，又作落拓},飥{餺飥},跅,託{委託，託付},蘀,籜,橐,柝,拓{開拓，拓展},托{托起，烘托},庹{量詞，兩臂平伸的距離（口語用弸或扳）；姓}
taam1	tʰam53	坍{(又)},貪
taam2	tʰam33	菼
taam3	tʰam55	䐺{食味美},黮{黮闇},撢{同探字},探{探路，試探},傝{傝儑}
taan1	tʰan53	嘽{嘽嘽},癱{(又)},灘,攤{擺攤，攤開},坍{坍塌}
taan2	tʰan33	亶{誠信；姓},鉭,袒,癱{癱瘓，面癱},璮,毯,忐{忐忑，源自憳忒/怛惕},坦,儃{儃儃}
taan3	tʰan55	嘆{嘆息，嘆氣；～茶，品茶，～世界，享清福，一說本字儃},碳,炭,歎{詠歎，讚歎}
taang1	tʰaŋ53	劏{俗字，宰殺，本字湯；路名，劏羊街，今當陽街},钂,鐋{鐋鑼},鏜{象聲詞，鏜鞳},鎲,蹚{蹚水；蹚地},耥{耥耙，又稱攤耙},羰,湯{雞湯，湯圓；宰殺，俗字劏},嘡
taang2	tʰaŋ33	倘{倘若，倘使},躺,蹚{(常)蹚水、蹚渾水，讀同躺/淌/倘},淌,惝{(又)},帑,儻
taang3	tʰaŋ55	摥{推，～櫳門，推式房門},鐋{平木石器；熱酒},趟{一趟，趟馬},燙,熨{(訓)熨斗，訓讀燙}
taap2	tʰap3	䍇{平底罈子，埕埕～～，罈罈罐罐，金～，骨灰（或骨殖）罈子},鰨{鰨目魚},鞳{鏜鞳},闒{闒茸},錔{(名)器物錔頭},褟,漯{古水名},溻{溻溼，溼溻溻},溚{焦油舊稱；古水名},榻{牀榻，榻榻米},搨{搨本，搨印},拓{同搨字，拓本，拓印},塔,塌{倒塌，塌方，塌臺；〈語〉扤[ŋat24]～皮，蹭破皮兒},嚃,嗒{嗒然若失},傝{傝𠎷}
taat2	tʰat3	㒓,鰨{(又)},韃,靸{靸拉},闥,遢{邋遢},達{(古)挑達},躂{踢躂，蹓躂},趿{趿拉},澾{滑也；～頭，光頭，俗字撻},溻{(又)溼溻溻，後字逆同化},榻{(又)榻榻米，後字逆同化},撻{撻伐；蛋撻，英語tart},塌{(又)塌臺；拖塌，同拖沓/拖遝}
taau1	tʰau53	叨{叨光},饕,韜,縚,絛,滔,搯{掏，挖取},挑{(古)挑達},慆,弢
taau2	tʰau33	䵚,討
taau3	tʰau55	套
tai1	tʰɐi53	梯,鷉,鷈,銻{金屬元素，符號Sb；〈語〉金屬鋁，因色近故稱，～崽，硬幣，～桶，鋁桶}
tai2	tʰɐi33	体,體
tai3	tʰɐi55	剃,髢,裼{載衣之褓},薙,涕{鼻涕},替,屜{抽屜},嚏
tak2	tʰɐk3	忑{忐忑，源自憳忒/怛惕},鋱,脦{肋脦，不正容止也},慝{惡},忒{忒好，忒大}
tam3	tʰɐm55	探{(白)裝入（衣袋）},𧨾{哄騙，尤指哄孩子，讀同形近字探，本讀蟾},撢{(白)}
tan1	tʰɐn53	吞,飩{餛飩},焞{光明},暾
tan2	tʰɐn33	墩{(白)又音，厚～～，很厚},氽
tan3	tʰɐn55	褪{～後，後退；～車，倒車}
tang1	tʰɐŋ53	膯{飽；〈語〉脹、膨脹，菜乾浸～去、球～喇 },鼟
tang3	tʰɐŋ55	戥{(又)像某人一樣做某事，你有錢可以冇做工，我冇～得你}
tap2	tʰɐp3	錔{(動)套上；貼近}
tat2	tʰɐt3	趿{(白)～跳跳，蹦蹦跳跳；走動、遊逛，到處～}
tau1	tʰɐu53	偷
tau2	tʰɐu33	㪗{～氣，歇氣，又作敨字},敨{同㪗字，～氣，歇氣},唞{俗字，休息，本字㪗/敨}
tau3	tʰɐu55	咅,透{透明，熟透；～火，生火}
tet2	tʰɛt3	撻{(白)擦（屁股），屙屎冇得閒～，忙的誇張說法}
tet3	tʰɛt5	澾{(白)滑～～，（路等）很滑}
teu2	tʰɛu33	挑{(白)提，～水，提水}
tik2	tʰek3	俶{俶儻，即倜儻},逖,踢{踢球，猛踢；一腳～，一手包辦},趯{跳貌},擿{挑出；揭露},惕{警惕，惕勵，怛惕},剔{挑剔，剔除；一～，漢字筆畫之一，即挑},倜
tim1	tʰim53	添,黇
tim2	tʰim33	㮇{㮇筆},舔{以舌取物},栝{撥火棍；木杖},掭{掭筆，本字㮇},忝
tin1	tʰin53	天
tin2	tʰin33	㥏{(又)},靦{(又)},覥{(又)},腆{(書)},町{町疃},淟{(又)},晪{(又)},捵{(又)}
tin3	tʰin55	瑱{玉名；耳飾}
ting1	tʰeŋ53	听{同聽字},鞓,聽{聽見，聽從，聽裝},綎,町{(又)地名，讀同汀},烴{碳氫化合物},汀{汀洲，水門汀},桯{桯子，桯凳},朾{虛朾，宋地},廳
ting2	tʰeŋ33	侹,頲,町{町畦},珽,挺{挺胸，堅挺},圢
ting3	tʰeŋ55	听{同聽字},聽{聽任，聽政，俗讀聽見之聽}
tip2	tʰip3	䑜{小舐},跕{跕屣},貼{體貼，貼身，補貼},萜,帖{碑帖，請帖，妥帖}
tit2	tʰit3	銕{同鐵字},餮,鐵
tiu1	tʰiu53	䠷,祧,挑{挑擔，挑戰，挑選},佻{輕佻}
tiu3	tʰiu55	朓,跳{跳高，跳舞；～皮，調皮、頑皮},趒,糶,眺
to1	tʰo53	拕,拖{拖拉，拖船}
to2	tʰo33	妥{妥當，穩妥},橢{橢圓}
to3	tʰo55	唾{唾液，唾棄}
toek2	tʰœk3	𢬳{扽，出力～，～斷}
toeng1	tʰœŋ53	嗵,通,熥,樋,恫{恫瘝},囱{(訓)},囪{(訓)煙囪，訓讀通}
toeng2	tʰœŋ33	㛚,統,桶{水桶，櫃桶（抽屜）},捅{捅破，捅穿}
toeng3	tʰœŋ55	痛
tot3	tʰot5	脫{(白)滑，～滑梯，滑滑梯}
tu1	tʰu53	㻬{㻬琈}
tu2	tʰu33	土,釷
tu3	tʰu55	兔,菟{菟絲},堍,吐{吐痰；嘔吐}
tui1	tʰui53	推{推開，推動},焞{盛}
tui2	tʰui33	腿
tui3	tʰui55	侻{舒緩貌},退,褪{褪色},蛻,煺
tuk2	tʰok3	禿{禿頂，光禿禿}
tun1	tʰun53	湍,猯,煓
tun2	tʰun33	疃
tun3	tʰun55	彖
tut2	tʰut3	侻{簡易},脫{脫離，解脫},梲{杖},挩{解脫；遺漏}
u1	∅u53	烏{(又)}
uk2	∅ok3	矱,齷{(常)俗讀},雘,臒,肟{有機化合物，英語oxime音譯}
ung1	∅oŋ53	尢{部首；同尪字},汪{汪洋，水汪汪；姓},尪
ung2	∅oŋ33	枉
ung5	∅oŋ24	往,暀{光；德；是}
waa1	wa53	凹{同窪字},譁{譁然，喧譁},蛙{青蛙，蛙泳},花{花朵，浪花},窪,窊,畖,洼{同窪字},娃{娃娃},嘩{象聲詞，水流聲；同譁字},喎{同咼字，嘴歪},哇{哭聲；嘔吐；語氣詞},咼{嘴歪斜}
waa2	wa33	搲{(文)}
waa3	wa55	化{化學，分化},𠹁{小兒啼}
waa4	wa21	划{划船，划槳，划算（口語稱抵值），划拳（口語稱猜碼）},驊,鏵,華{中華},樺{樺樹},搳{搳拳},崋,嘩{嘆詞，表讚歎},哇{(語)表讚歎，又作嘩字}
waa5	wa24	佤,踝,瓦{瓦片；瓦解},娃{(白)娃[wa21]～，嬰兒}
waa6	wa22	吧{(白)句末語氣詞，表推測，俗字哇，今日冇會落雨～？},話{講話，話劇，話題},觟{有角母羊},華{華山、姓，俗讀中華之華},畫{名詞，圖畫，畫眉鳥；動詞，畫圖},崋{(又)},嬅,哇{(語)表推測，相當於官話的吧，今日冇會落雨～？}
waai1	wai53	歪{歪曲，歪斜，本字竵},溾{溾浽}
waai3	wai55	噲,駃{快馬；通快字},筷{筷子，碗筷},快{(白)快慢，快速；～菜，苣蕒菜},塊{一塊，土塊}
waai4	wai21	怀,耲,淮,槐,懷
waai6	wai22	坏{同壞字},外,壞
waak5	wak24	掝{(語)～手，招手，疑本字劃/攉}
waak6	wak2	劃{計劃，劃分},掝{裂開}
waan1	wan53	壪,灣,彎
waan2	wan33	挽{挽留，挽手，挽住},輓{輓聯，輓歌},緩,綰
waan4	wan21	䴉,鬟,闤,鐶,鍰,郇{姓},還{〈副〉還有，還是；〈動〉還錢，還原},轘{轘轅},繯{(又)},環{環境，耳環},澴,桓{(又)},寰,嬛{琅嬛},圜{環繞、圍繞}
waan5	wan24	皖{安徽},鯇{鯇魚}
waan6	wan22	宦,轘{轘刑},豢,翫,繯{投繯，繯首},玩{玩耍，玩笑；玩世，古玩},漶,擐{(又)},患,幻
waang5	waŋ24	撔{(語)繞道、抄近路，或爲屈路行的合音，又或暀[kʷɐŋ22]（圈、繞）的音變}
waat2	wat3	嗗{飲聲},穵{(文)},斡{斡旋；地名，陸斡},挖{(文)}
waat3	wat5	滑{(語)生～～，（鷄、魚等）活蹦亂跳}
waat6	wat2	滑{地滑，滑冰；〈又〉滑稽},猾{狡猾}
waau2	wau33	媼{(白)阿～，舊時稱母親}
wai1	wɐi53	倭{(古)倭遲},麾{(又)},隳{(又)},逶,輝{(又)},覣,褘{(又)},蝛,葳,翬{(又)},癐{象聲詞},琿{(又)璦琿},煇{(又)},暉{(又)},撝{(又)},揮{(又)揮手},徽{(又)},崴{崴嵬；崴子},媁{好看、漂亮，～水，俗字威},威,委{虛與委蛇},噅{(又)}
wai2	wɐi33	偉{偉大，雄偉},骫,韡,韙,譭{詆譭},諉,虺{虺蛇},虫{虺的本字},薳{草名；姓},蔿,蒍,萎{枯萎，萎縮，氣萎},緯,碨{碨磊},痿,瑋,燬{焚燬},煒,毀{毀滅},暐,廆{人名用字},委{委託},唯{唯唯諾諾},卉,儰
wai3	wɐi55	䲁,霨,螱,蔚{蔚然},翽,穢,磑{同碨字，石磨},碨{石磨},畏,猥{猥瑣，讀同畏},慰,尉{太尉},噦{噦噦},喂{喚叫聲},偎{(又)讀同畏}
wai4	wɐi21	危,鮰{鮠魚},鮠{魚名},韋,闈,違,迴,蛔,葦{蘆葦},茴{茴香},維{維護},琟,爲{作爲；〈語〉計算，～得過（做得過），划得來，～冇過（做冇過），划不來},烠,為{同爲字},濰,潿,湋,洄,桅{桅杆},惟{惟恐},徊,幃,帷,巍,嵬,圩{圩堤},圍,回,唯{唯獨，唯物論}
wai5	wɐi24	喂{(語)句首表引起注意，句末表祈使}
wai6	wɐi22	位{位置，地位，單位},𠅤,魏,鏏,遺{(古)贈也},譓,謂,諱,衞{同衛字},衛{保衛，衛生},蟪,蝟{刺蝟，蝟集},薈{蘆薈，薈萃，讀同會},蕙,蔧{(又)},胃,繪,繢,爲{爲了},燴,煟,為{同爲字},潓,渭,橞,會{開會，會議，社會；冇～，不會；會計；會稽},憓,慧{智慧，慧眼},惠,恚,彙{詞彙，彙集},彗,喟{喟嘆，讀同胃/謂},匯{匯聚，外匯},僞{虛僞},偽{同僞字}
wan1	wɐn53	勛{勳的古字},鰮,馧{香},頵,閽,醺,轀,贇,薰{薰衣草，薰香},薀{水草名},蒕,葷,纁,縕{絪縕},瘟,獯,燻{煙燻，燻肉，與爩對轉},熏{熏陶，熏風},熅{無焰的火},溫{溫習，體溫},氳{氤氳，氛氳},氲,殟,榲{(又)},曛,暈{〈形〉頭暈，源自昏；〈動〉暈車，暈倒},昏{昏迷，黃昏，昏暗；～嗲[te21]嗲[te21]，暈頭轉向、頭暈不舒服},惛{糊塗},婚{結婚，婚姻},塭,勳{功勳，勳章}
wan2	wɐn33	搵{沒也},穩
wan3	wɐn55	困{(白)囚禁，與屈對轉},馴{(常)俗讀，讀同訓},韞,醞,訓{教訓，訓練},蘊,薀{通蘊字，積聚},縕{亂麻；舊絮},瞓{累，本字睏},睏{(白)累乏},搵{按、壓},慍{慍色，慍怒}
wan4	wɐn21	云{詩云，人云亦云},魂{鬼魂，魂魄；失～鬼，指怕事的人},餫{餛飩},餛{餛飩},雲{彩雲，雲集},鋆{金},鄖,蕓{蕓薹},芸{芸香，芸芸},耘,紜,篔,筠{筠竹},畇,琿{玉名；琿春市},澐,溳,渾{渾濁，渾身，渾然},沄,昀,妘,員{增益；古人名，伍員},勻{均勻，勻稱}
wan5	wɐn24	允{允許，應允},隕,狁,殞,尹{姓}
wan6	wɐn22	員{姓},餫{運糧},韻,鄆,運,逭,諢,瘓,熨{熨斗，本字熅},熅{熨},煥,溷,渙,混{(文)混帳，矇混},暈{(名)日暈},換,惲,婫{覆蓋},奐,圂,喚
wang1	wɐŋ53	稗{(訓)～子，稗子，疑本字菵，明母讀如匣母}
wang6	wɐŋ22	懵{(白)～掙[tʃɐŋ55]掙[tʃɐŋ55]，發呆；癡癡～～，癡癡呆呆；～怐[hɐu55]怐[hɐu55]，呆呆傻傻；案，母亙切，明母讀如匣母，不明也，元曲作懞掙，懞與懵通}
wat2	wɐt3	㩿,黦{(又)黃黑色},魆,鬱{憂鬱},馧{馧馞},詘{辭塞；彎曲},蔚{地名，蔚縣（在河北）},菀{茂盛},膃,胐{臀；屎～，屁股，屎～竉，肛門，俗字窟},窟{窟窿，洞窟},矻,爩{煙氣；〈語〉燻，與燻對轉},熨{熨帖},榲,搰{搰搰},掘{(又)},崛{(又)},屈{委屈，屈服；姓；～着腳，扭傷腳；～頭雞，未孵出殼死在蛋裏的小雞兒},尉{尉遲（複姓）},堀,倔{(常)倔強，讀同屈},䓛,㳚
wat5	wɐt24	抇{(語)攪動，～糨糊，攪糨糊},鷸,遹,矞,燏,潏{水流貌}
wat6	wɐt2	佸,𣝗,鶻{鶻突，回鶻},聿,活,核{果核，棗核，本字𣝗},搰{掘也；擾亂},抇{同搰字，掘也},慍{(語)憋，～氣，憋氣、有怨氣，疑本字屈}
wau3	wɐu55	汪{(語)象聲詞，狗吠聲，狗～～}
we2	we33	哇{(白)嘔吐，～得世，嘔吐得厲害，俗字噦},搲{(白)撓，抓},噦{(訓)嘔吐，～得世，嘔吐得厲害，本字哇，吐也}
we6	we22	唄{(白)語氣詞，你想去就去～，俗字𠹁},𠹁{(語)句末語氣詞，相當於官話的唄}
wet2	wɛt3	挖{(白)},穵{(白)同挖字}
wiak6	wiɐk2	㗲,𦑌{飛聲},鸌,騞{騞然},謋,蠖,籰{收絲器},穫{收穫},砉,獲{獲得},濩{煮},彠,嫿,嚄{嚄唶},劐{(又)},剨,㩇{擘也}
wiang4	wiɐŋ21	橫{橫豎；蠻橫，古讀去聲}
wiang6	wiɐŋ22	撔{橫也}
wik5	wek24	域{區域，領域},閾,蜮,疫,棫,役
wing1	weŋ53	兄{兄弟，老兄}
wing4	weŋ21	塋,鎣,縈,瑩,營{經營，營養},瀠,瀅,濚
wing5	weŋ24	咏{同詠字},詠{歌詠，詠歎},穎,潁,泳,永,栐
wo3	wo55	喎{粵字，語氣詞，表提醒或讚歎，一說喎本爲噃的弱讀}
wo5	wo24	喎{粵字，語氣詞，表祈使或反問}
wu1	wu53	嗚{嗚呼，嗚咽},靰,鎢,鄔,肟{(又)讀同污},烏,洿,污{污泥，貪污},汙{同污字},於{(古)於戲，於菟},塢{山塢，船塢，讀同烏},圬
wu3	wu55	噁{喑噁},惡{可惡，厭惡}
wui1	wui53	偎{依偎，偎傍},鰃,隈,煨{煨番薯},溾{(語)溾浽（污穢、骯髒），又作渨涹},渨,椳
wui3	wui55	喂{同餧/餵字},餵{餵養，餵飯},餧{餧飯，後作餵}
wuk6	wok2	鑊{鍋；量詞}
wun1	wun53	婠
wun2	wun33	剜,豌{豌豆},蜿{蜿蜒},腕,脘{(又)},碗,椀,惋{惋惜},帵,宛{宛如},婉{婉轉}
wun4	wun21	垣,雈,貆,萑,荁,綄{候風羽},瓛,洹,桓{盤桓；姓},峘
wun5	wun24	㬊,莞{莞爾},綄{纏繞},澣,浣
wun6	wun22	妧{美好貌},翫{(書)},玩{(書)玩世，古玩}
zaa1	tʃa53	偺{同咱字},𠭯,齇,髽,蹅{足蹋聲},膼,猹,渣{殘渣，渣滓},樝{山樝，又作山柤},楂{山楂},查{同楂字；姓},柤{山柤，即山樝},撾{敲、打},摣{握、拿},揸{同摣/𠭯字，握、拿},挓,抯,抓{(訓)握、拿，俗字揸，本字摣/𠭯},奓{地名，奓河、奓山（在湖北）},喳{擬鳥聲，吱吱喳喳},喒,咱{俗字，自家或自家們的合音},吒{哪吒}
zaa2	tʃa33	䕢{藞䕢},鮺,鮓{鮓肉},苴{土苴},苲{苲草},砟{砟子}
zaa3	tʃa55	䃎{地名用字},詐,蜡{年終祭名},蚱,笮{榨酒器},砟{碑石},痄{痄腮},煠{油炸之炸本字},炸{炸彈，本字灹；油炸，本字煠},灹{火聲},溠,榨{榨油},柞{地名，柞水（在陝西）},搾{同榨字},拃{張開大拇指與中指測長度（口語用揇）；量詞},奓{張開},喳{(語)～喇[la55]蟲，蟬},咋{同乍字；咋呼，咋辦},厏,乍{乍到，乍暖}
zaa4	tʃa21	垞,𥻗,餷,茶,茬{麥茬},苴{枯草},碴{找碴，冰碴，拉碴},槎{木筏},查{調查，查證},搽{搽藥，搽粉},嵖
zaa5	tʃa24	苴{(語)劣質的}
zaa6	tʃa22	槎{逆斫木；〈語〉用荊棘攔住或蓋住，～住園門，冇許雞落去；～地方、～處，佔地方},𧨊{𧧝～，囉唆、糾纏},齰{齰齖}
zaai1	tʃai53	㨁{(白)投擲，韻母演變同踩/跐字，俗字拽},齋,菑{同災字},甾{有機化合物},災,栽,哉
zaai2	tʃai33	䍉,載{年載，俗讀載重之載},滓{(訓)渣滓，訓讀崽/仔},崽{小子或動物幼子，俗字仔},宰,囝{(訓)訓讀崽},仔{仔女，本字崽，另一說子字止攝白讀}
zaai3	tʃai55	債,載{載重，滿載，記載},祭{姓},瘵,再,儎
zaai4	tʃai21	儕{同儕},財,豺{豺狼},裁,茈{茈胡},纔{剛纔，纔來，纔得},材,才{才華，人才}
zaai6	tʃai22	㩟{縫綴},豸{(又)},砦,拽{投擲，本字㨁},廌{(又)},寨,在{現在，在位，實在（誠實；的確、其實）}
zaak2	tʃak3	作{工作，作坊}
zaak3	tʃak5	鑿{(白)鋤}
zaak6	tʃak2	岞,鑿{開鑿；鑿子},酢{酬酢},笮{竹索},砟{砟硌},柞{柞木，柞蠶},昨{昨晚，昨日},擲{(又)～陀螺，～色子},怍
zaam1	tʃam53	簪,糌{糌粑}
zaam2	tʃam33	䁪,斬,嶄,寁
zaam3	tʃam55	偡{齊整},蘸{蘸墨，蘸醬},湛
zaam4	tʃam21	儳{不齊},饞{嘴饞},鑱{長鑱；刺入，與插對轉，又作攙/劖字},讒{讒言},蠶{蠶蟲，蠶豆},蚕,瀺,攙{刺入，與插對轉，又作鑱/劖字},慚{慚愧},巉,劖{刺入，與插對轉，又作鑱/攙字}
zaam5	tʃam24	㔆{割；剪；刺},鏨{(又)鏨子}
zaam6	tʃam22	暫,鏨{鏨花，鏨子},蹔,站{站立；車站}
zaan2	tʃan33	㜺{好看、漂亮},驏,趲{趕路；移、挪；走～，走板、錯位},盞{燈盞，一盞燈},琖,昝{姓},攢{(文)慳～，積攢},拶{拶子},儹{(文)}
zaan3	tʃan55	濽{同灒字},酇{古縣名；姓},贊{贊助，贊成},讚{稱讚，讚揚},瓚,灒{水濺，又作濽字}
zaan4	tʃan21	慚{(常)俗讀},饞{(又)},讒{(又)},蠶{(常)俗讀},蚕{(又)},殘{殘疾，摧殘}
zaan6	tʃan22	䋎{補縫},賺{賺錢，賺取},虥,綻{破綻},灒{(語)濺},濽{(語)濺},濺{(訓)訓讀灒/濽},棧{客棧；棧道},䗃{馬䗃}
zaang1	tʃaŋ53	䁓{(語)偷看，～看，俗字裝},髒{骯髒},贓{贓物，貪贓},裝,莊,臧,粧{同妝字},牂,庄,妝{化妝，妝扮}
zaang2	tʃaŋ33	駔{壯馬；駔儈}
zaang3	tʃaŋ55	壯{強壯},葬,戇{戇直}
zaang4	tʃaŋ21	藏{隱藏}
zaang6	tʃaŋ22	僮{僮族},藏{寶藏},臟{內臟，五臟},狀,奘{粗大；玄奘}
zaap2	tʃap3	㴙,𥀈{皮老},譗,紮{(語)～馬步、～屙屎馬，又作劄字},砸{砸傷，讀同匝},眨{眨眼},抸{持也},扎{(語)～馬步、～屙屎馬，又作劄字},咂{咂嘴},匝{一匝，匝道},劄{用針劄，劄記；～馬步、～屙屎馬，又作紮/扎字},偛
zaap6	tʃap2	喋{唼喋},雜,閘{水閘，閘門，本字牐；馬～，坐具，即馬紮/馬札},鍘{(訓)鍘刀，訓讀閘},紮{(語)馬～，坐具，又作閘字，一說本作馬棧，棧爲簀音轉},牐{閉城之門},扎{(語)馬～，坐具，又作閘字，一說本作馬棧，棧爲簀音轉}
zaat2	tʃat3	哳,軋{碾軋；軋鋼；象聲詞},蚻{小蟬},紮{包紮，駐紮，一紮},札{筆札，信札},拶{逼，擠壓},扎{扎針，掙扎}
zaat3	tʃat5	濽{(語)又音，濺},灒{(語)又音，濺}
zaat6	tʃat2	甴{俗字，曱～，蟑螂，本字甲蚻，前字受後字逆同化},窒{(白)肚～，消化不良}
zaau1	tʃau53	啁{啁哳；啁嘐},遭,蹧,糟,嘲{嘲諷，嘲笑}
zaau2	tʃau33	找{尋找，找錢},蚤{跳蚤（口語稱跳蝨）},藻{水藻，小球藻},繰{絳紫色帛},璪,璅{似玉的石},爪{爪牙，雞爪},澡,棗,早,抓{搔、撓}
zaau3	tʃau55	㷹{用油炸；油～鬼，油條},罩{罩住，口罩},笊{笊籬},竈{爐竈，竈神},炸{用油炸，本字㷹},灶{同竈字}
zaau4	tʃau21	勦{輕捷也；勞也},𥕢,螬,艚,漕,槽{馬槽，跳槽},曹,巢{巢穴，鳥巢},嘈{嘈雜，嘮嘈（同㗦嘈）；～天巴閉，吵吵嚷嚷}
zaau5	tʃau24	造{(白)～火，生火，麻雀～竇，麻雀建窩}
zaau6	tʃau22	唕{囉唕},造{製造，造船，早造；造詣，古讀七到切},簉,皂{肥皂},皁{皁角，青紅皁白},櫂{槳；划，～龍船；～忌，忌諱},棹{同櫂字，棹船，棹歌},慥{慥慥}
zai1	tʃɐi53	擠{(語)攢聚，檯上亞啲嘢～做一起},齏,齎,隮,躋{躋身，攀躋}
zai2	tʃɐi33	擠{排擠，擠迫，擁擠},濟{人才濟濟；濟南}
zai3	tʃɐi55	劑{(又)},鰶,霽,際,迣,穄{穄子},祭{祭祖},磜,狾,濟{經濟},漈,晢{(又)}
zai4	tʃɐi21	儕{(白)～家、大～，大家},齊{整齊，齊全；完，吃～},鱭,鮆{刀魚，又作鱭字},蠐,薺{荸薺（源自葧臍，口語稱馬蹄）；薺菜，讀同齊},臍{肚臍，臍帶}
zai6	tʃɐi22	劑{藥劑},齊{(古)火齊},癠,滯{停滯，滯留；肚～，消化不良},嚌{嚐}
zak2	tʃɐk3	仄,鰂{同鯽字},鯽{(習)鯽魚，俗字鰂},昃,則,側{側面，兩側}
zak6	tʃɐk2	鑿{(白)刺、扎，用筷子～看過，扣肉得𱤜}
zam1	tʃɐm53	斟,鍼{鍼砭，鍼灸},鍖{同椹字},針{針線，針對},葴,箴,祲,砧{擣衣石；同椹字，砧板},瑊,椹{墊板，砧板}
zam2	tʃɐm33	怎,枕{(名)枕頭}
zam3	tʃɐm55	揕{刺也；擊也},譖{譖言，毀譖},浸{浸泡，水浸（水淹）},枕{(動)枕藉，枕戈待旦}
zam4	tʃɐm21	噚,鱘,鐔{姓},鄩,覃{姓},蟳,蟫{蟫蟫},蕁{蕁麻，蕁麻疹，讀同尋，本字䕭/燅，本音潛},璕,爓{同燖字},燖,潯,潛{(又)},涔,沉{同沈字，沉沒},沈{沈沒},梣,撏{取也},岑{岑寂；姓；地名，岑溪},尋{尋找；走訪，～朋友}
zam5	tʃɐm24	㔆{(白)用刀把東西分成若干部分；用指甲戳、摳}
zam6	tʃɐm22	朕,鴆,沉{(白)沒入水中，本字沈},沈{沒入水中，～落去，俗字浸}
zan1	tʃɐn53	忳{同諄字},迍{迍邅},諄,衠,蓁{草盛貌},臻,胗{胗肝},肫{肫肫；雞肫},罇{同樽字},窀,禛,真,眞,甄{甄別；姓},瑧,珒,珍,獉,溱{溱頭河},津,樽{盛酒器；〈語〉瓶},樼,榛
zan2	tʃɐn33	儹{(又)},隼{鷹隼，讀同準},軫,診{急診，診療},袗,胗{嘴脣潰瘍},縝,綧,稹,疹{麻疹，溼疹},畛,準{標準，準備},槙{木密},昣,攢{(又)～拾，收拾，～錢，攢錢},埻{箭靶},准{批准，准予}
zan3	tʃɐn55	䟴{(書)},駿,餕,震{地震，震驚，震撼},雋{同俊字},鎮,進,賑,葰{大},臸{前往},縉,竣,睃{(又)},畯,甽{溝渠},璡,瑱{通鎮字；瑱圭},瑨,焌{點火},濬{深也；疏通},溍,浚{深也；疏通},晙,晉,搢,振{振作，振奮，共振},峻{峻嶺},圳{深圳；溝渠，本字甽},儁,俊
zan4	tʃɐn21	嗪,陳,螓,蓁{蓁椒},臣,秦,溱{溱潼},塵{灰塵，塵土}
zan5	tʃɐn24	攥{(白)手指聚攏擠壓，～啲汁出來}
zan6	tʃɐn22	儘{儘管，儘量},陣{佈陣，陣雨},贐,藎,紖,盡{耗盡，盡力；遴[lɐn22]～，不利索、麻煩},燼,濜,敶
zang1	tʃɐŋ53	䎖,鬙{鬅鬙},鬇{髪亂},錚,罾{魚～，魚網},繒{絲織品總稱},綪{屈曲},箏{風箏},矰,睜,琤,猙,曾{姓},掙{掙脫，掙扎},憎,崢,增,噌{象聲詞；泓噌；叱責},僧{僧人，高僧，讀同曾/增},䦛,䒏{䒐䒏，神不爽也}
zang3	tʃɐŋ55	掙{(語)懵[wɐŋ22]～～，發呆；案，明代小說中掙掙表發呆貌},諍{諍言},甑{飯甑，甑子}
zang4	tʃɐŋ21	䁬,鄫,橙{(又)},曾{曾經},嶒,層{樓層，層次},倀{獨立貌}
zang6	tʃɐŋ22	掙{掙錢},贈,繒{綁；紮}
zap2	tʃɐp3	執{執行，執筆；檢查，～漏，檢漏},臢{腌臢（不潔）},縶,汁
zap6	tʃɐp2	㗱{噍也},鰼,霫{霫霫},集,隰,襲{襲擊，偷襲},習,嶍,㿇{痺疾}
zat2	tʃɐt3	㰵{吮吸；飲},騭,鑕,質{質量；人質，古讀去聲，陟利切},蟀{～～，蟋蟀；蟋[ɬɐt3]蟀},窒{(白)動詞，塞；名詞，瓶塞；屈～，狹小侷促},礩{柱下石},櫍,晊,揤,崒{(又)},嘬{吮吸，本字㰵},卒{兵卒，卒業}
zat6	tʃɐt2	侄{同姪字},銍,郅{郁郅},螲{螻螲},螏,蛭,蒺,膣,窒{窒息，窒礙},礩{通窒字},疾{疾病；〈語〉個子瘦小，～崽},椊,桎,朮{白朮，蒼朮，俗讀同術/述},捽{揪},挃{撞；割禾聲},庢{盩庢縣},崒,嫉,姪{姪子，姪女，內姪，堂姪},厔{同庢字}
zau1	tʃɐu53	周{周圍，四周，周全；姓；～時，經常、時常},𩭓{梳個𩭓，又作鬏字},鵃,鯫,鬏{梳個鬏，本字𩭓},騶,陬,鄹,鄒,週{週期，週刊，週末},輈,賙,譸,謅{瞎謅，胡謅},諏,蝤{蝤蛑},舟,緅,盩{盩庢縣},湫{湫水河},洲{綠洲，沙洲，亞洲},揫{揫住},揪{同揫字，揪住},掫{巡夜打更},州{九州，州縣},婤,喌{呼雞聲},啾{啾唧},啁{啁啾}
zau2	tʃɐu33	帚,酒,走{走路；奔走，～難，逃難},肘
zau3	tʃɐu55	㑳,縐{文縐縐，縐紗},皺{皺紋，褶皺},椆{木椆},晝,揍,奏,咒,僽{僝僽},㥮
zau4	tʃɐu21	儔,酬,酋,遒,躊,讎{校讎，讎定},蝤{蝤蠐},綢{綢緞，絲綢},紬{粗綢},籌,稠,疇,犨,泅{泅水，泅渡},椆{椆木，椆水},惆,幬{床帳；車帷},囚
zau5	tʃɐu24	葤{(白)量詞，一小串，一～葡萄/荔枝/龍眼}
zau6	tʃɐu22	㠇,鷲,鮦{鮦陽},驟,酎,袖,葤{裹也},胄{貴胄，世胄},繇{卦兆辭},紂{桀紂},籀,岫,就,宙,冑{甲冑，介冑},僦
ze1	tʃe53	啫{啫啫煲，啫喱},遮{遮蓋，遮擋},嗻{多語之貌},嗟
ze2	tʃe33	姐{姐妹，阿姐，表姐，堂姐},鍺,赭,者,毑
ze3	tʃe55	䗪,鷓{鷓鴣},藉{藉口，慰藉，憑藉},蔗{甘蔗，蔗糖},柘,擠{(語)動詞或形容詞，擁、擁擠},唶{歎聲},借{借用，借貸，假借}
ze4	tʃe21	㙦,輋{地名用字},斜{斜坡，傾斜}
ze5	tʃe24	這{這邊}
ze6	tʃe22	塮,𩛌{(白)～䭑[lem21]，小孩嘴饞},謝{多謝},榭
zen5	tʃɛn24	掐{(訓)掐，～頸，本字攥},攥{(白)用手虎口緊按，～手～腳、～頸}
zep2	tʃɛp3	眨{(白)～眼，擠眼}
zep3	tʃɛp5	咂{(白)～口脣，咂嘴脣；～相，咂嘴貌}
zet3	tʃɛt5	擳{(白)擠（牙膏）；胳肢（動詞）},瀄{(白)擠水濺出，與濺對轉}
zeu3	tʃɛu55	啁{(白)～嘐[lɛu55]，嘴巴厲害}
zi1	tʃi53	䟡{同胝字},𦭜,齜{齜牙},齍,齊{(古)齊衰},鼒,鶅,鳷,鯔,髭,鎡,錙,鈭,鄑,遮{(白)},輜{輜重},趑,資,貲,諮,訾{衡量；姓},觜{二十八宿之一},衼,蜘{蜘蛛},菑{田一歲},茲{茲日},芝,臸{到達；如一},脂{胭脂，脂肪},胝,胑,肢,緇,粢,秪,祗,知{知道；知識},畠{同甾字},甾{同淄字},澬{久雨積水；水名},滋,淄,泜{泜河},汥{水聚積},氏{月氏，閼氏},榰,椥,椔,梔{梔子花},栺{栺栭},枝{樹枝，荔枝，一枝花；青～～，青紫色},支,恣{恣意，恣睢，讀同資},巵{巵言，玉巵},嵫,孳,孜,孖{雙生子，本讀},姿{姿勢，舞姿},嗞,咨,呲{同齜字},吱,卮{同巵字},之
zi2	tʃi33	仔{仔細；仔肩},黹,阯,酯,軹,趾,訿,訾{詆毁},衹{通祇字},虸,茝{白芷},茋,茈{茈草},芷,芓{同耔字},胏,耔,紫,紙,籽,笫,秭,祉{福祉，祉祿},祇{同只字，僅僅},疻,滓{渣滓，泥滓},沚,汦,止,梓,栺{木名},枳,旨,指,扺,恉,徵{五音之一},子{子孫，瓜子，一下子，一輩子},姊{姊妹，姊弟},坁,址,啙,咫,呰,只{只有，只好},厎
zi3	tʃi55	䎺{入意；聞也},鷙,鷓{(白)},騺,駤,輊,躓,贄,識{(古)標識，博聞強識},誌{雜誌},觶,製{製造，製作},藉{(白)},蔗{(白)},致{導致，致敬},至{至少，甚至；副詞，纔、最、再},自{(白)捫[mon55]～，怕羞},胾{切成大塊的肉},置,緻{細緻，精緻},礩{(又)柱下石},知{通智字；姓},瘈{狂犬也},痣,疐{跋前疐後},潪{水名},梽,智,摯,掣{掣肘，風馳電掣，讀同制},懫,懥,忮,志{志向},寘,剚,制{制度，制止；〈語〉開關，俗字掣},倳,借{(白)}
zi4	tʃi21	匙{匙羹，湯匙},鷀,鶿,馳,餈{餈粑},遲,辭,踶{踶躕},踟,趍{趍趙},貾,詞,蚳,薋,荎,茲{古國名，龜茲},茬{草盛貌；姓},茨,茌,茈{鳧茈},糍{同餈字},篪,祠{祠堂，宗祠},磁{磁石},瓷{瓷器},濨,澬{古水名},泜{水名，在河北},池,歭{歭躇，同踟躕},柌,持,慈,弛,墀,坻{水中高地}
zi6	tʃi22	㨁{投；持},飼{飼料，飼養},食{(古)簞食壺漿},雉{雉雞},阤{山坡},鈶,跱,豸{蟲豸，獬豸},謝{(白)姓；～夜/日，昨夜/日},芓{同茡字；隄},自{自己，各自},耜,稚{幼稚，稚嫩},祀{祭祀},眥{眼眶},痔,畤,牸{牸牛},滍,泜{水名，在河南},治,汜,歭{同偫字},杝{析薪},昨{(訓)昨夜/日，本字謝},彘,廌,庤,巳{辰巳},峙{對峙},寺{寺廟，清真寺},字{文字，字畫；一個～，五分鐘},姒,嗣{子嗣，嗣位},兕,傂,偫
ziak2	tʃiɐk3	㩇{裂聲},鐯,酌,迮,賾,責,謫,著{衣著，著衫，俗作着},芍{芍藥},舴,繳{繫在箭上的絲繩},簀,笮{狹窄；姓；〈語〉壓，俗字矺/磧},窄,禚,磔{張也開也},矺{磓也；同磔字},着{衣着，着衫},皭{(又)},爵,爝,灼,汋{激水聲；通酌字},柞{砍，斜斫},斮{斬也},斫{斧刃；斧砍},摘,幘{(又)},妁,嚼,嘖{嘖嘖，嘖有煩言},唶{嚄唶},咋{大聲；啖也、齧也，咋舌},勺{通酌字}
ziak6	tʃiɐk2	䶡{同齰字},齰{齰舌},躑{躑躅},蹢{蹢躅，同躑躅},著{著涼，睡著；棋高一著（口語用招）；俗作着},翟{姓},着{着涼，睡着；棋高一着（口語用招）},澤,泎{水落貌},擿{搔，撓；投擲，後作擲},擲{投擲，古字擿},擇{擇菜，選擇},宅
ziang1	tʃiɐŋ53	㬹{肘、腳跟，俗字踭，本地稱䐁[tœk3]，腳～},鱂,餦,鄣,踭{俗字，肘、腳跟，本字㬹，本地稱䐁[tœk3]，腳～},蟑,螿,章,璋,獐,爭{爭取，鬥爭；欠、差},漿{豆漿，漿糊},漳,樟,暲,彰,張,將{將來},嫜,丁{(古)伐木丁丁}
ziang2	tʃiɐŋ33	仉{姓},鞝{扇馬鞍皮},長{生長},蔣,礃,獎,漲{(又)漲水，漲價},槳,掌,奬
ziang3	tʃiɐŋ55	仗{打仗，勝仗，敗仗},障{保障},醬,賬{賬目，記賬},脹,瘴{瘴氣},漲{漲水，漲價；漲大},幛,帳{蚊帳，帳篷},嶂,將{大將}
ziang4	tʃiɐŋ21	場,長{長短},詳,薔,萇,腸{腸胃，大腸},翔,祥,盯{直視，又張梗切},牆,檣,棖,朾{朾螘；𧋦（尾）[me53]～，蜻蜓},撜{同掁字},揨,掁,戕,廧,庠,嬙,墻
ziang6	tʃiɐŋ22	䂻{硬塞；撐、飽肚},長{(古)身無長物，俗讀長短之長},象,蟓,橡{橡樹},杖,匠,像,仗{倚仗，炮仗，儀仗},丈{丈夫，姨丈，丈量}
zik2	tʃek3	勣,鶺,鯽{(書)},隻{一隻，隻身},陟,蹠,蹟{古蹟，遺蹟},蹐,踖,跡{足跡，跡象},跖,襀,蠀{尺蠖蟲},膱{油敗；脯脡},脊,職,織,績,積{積極，堆積},稷,磧{沙磧},癪,瘠,炙{炙熱},漬{(訓)污漬，浸漬，訓讀積},樴,摭,幟{(常)俗讀，讀同織},幘,嵴,尐{有花紋的雌蟬},堲,唧{啾唧，唧咕，唧唧},卽,即{即刻，立即}
zik6	tʃek2	㨁{拄杖},褯{褯子},蟄{驚蟄，古俗作京直},藉{狼藉},蓆{草蓆},耤,籍,穸,稙{早種禾},矽{硅的舊稱，英語Silicon},直,潪{水稍滲入土},湜,汐,殖,植,席{主席，酒席，草席},寂{寂寞},夕,埴,值
zim1	tʃim53	占{占卜，占卦},霑,譫,詹,覘{窺視},襜{(又)},粘{粘米（秈米），又作占米},瞻{瞻仰，觀瞻},漸{漸染},沾,櫼{(又)},憸{(語)㤿～，愛挑剔},嶦,尖
zim2	tʃim33	颭
zim3	tʃim55	佔{佔領，侵佔}
zim4	tʃim21	撏{拔、抽},灊,潛{潛水，潛伏}
zim6	tʃim22	漸{逐漸}
zin1	tʃin53	戔,鸇,鳽{同鸇字},鱣{鱘鰉魚},饘,韉,邅,箋{(書)本讀},煎{煎熬，油煎},濺{濺濺，水疾流貌},湔{湔洗，湔滌},栴,旃
zin2	tʃin33	剪,輾{輾轉},踐{實踐},譾,諓,翦,皽{死皮},戩
zin3	tʃin55	戰,顫{顫抖，打顫},薦{推薦，薦引},荐{草蓆；屢次},箭,牮
zin4	tʃin21	前,錢,辿,躔,纏{纏繞；糾纏},瀍,廛
zin6	tʃin22	濺{濺水，讀同賤，與瀄對轉},餞{餞行，蜜餞},賤
zing1	tʃeŋ53	偵{偵察},鼱,鶄,鯖{魚肉雜燴},鉦{古樂器},貞,蒸,菁,腈{精肉；有機化合物},精{精神，妖精；～靈[leŋ53]，機靈，實爲精的分音},箐{笭箐},禎,睛{眼睛},癥{癥結},烝,湞,正{正月},楨,晶,旌,怔,徵{徵求，特徵},征{征伐，長征}
zing2	tʃeŋ33	丼{同井字},肼,汫,整,撜{同拯字},拯{拯救},井{水井，井井有條}
zing3	tʃeŋ55	幀,證,証,症{症狀},正{正確，方正；～經，確實},政
zing4	tʃeŋ21	䝼{受賜},餳{飴，糖稀},酲,郢{(又)},逞{逞強，得逞，讀同呈},裎,腈{(又)讀同晴},程,珵,澄{澄清},澂{澄的本字},氰{碳氮化合物},晴,懲,憕,情,埕{罈子，～～䍇䍇，罈罈罐罐，酒～，酒罈子},呈
zing6	tʃeŋ22	䝼{賜予},靜,靚{裝飾也},靖,阱{陷阱},鄭,竫,淨{淨重，乾淨},擲{(又)讀同鄭},婧,凈{同淨字}
zip2	tʃip3	䀹{(又)},霅{霅溪},輒,讋,褶{皺褶，百褶裙},浹{浹洽，汗流浹背},楫{舟楫},摺{摺疊，存摺，摺扇},接,囁{(又)}
zit2	tʃit3	㘉{咇㘉},轍,節,癤,瀄{瀄汨，泌瀄},櫛{櫛比，讀同節},擳{挃擳},岊,尐{少},婕{婕妤},倢{倢伃，同婕妤},㵶{水灑也}
zit6	tʃit2	截{截斷，攔截；量詞},睫{睫毛},捷{快捷，敏捷}
ziu1	tʃiu53	僬{僬僥},鷦,鉊,詔{(常)俗讀，讀同招},蕉{芭蕉},礁,燋{引火用的柴},焦{焦土，焦點},沼{(常)俗讀，讀同招},椒,朝{朝早，今朝},昭{(又)},招,召{(訓)召喚、召集、徵召，訓讀招}
ziu2	tʃiu33	剿{剿滅，清剿},湫{低窪},沼{沼澤，沼氣},摷{拘擊},勦{勞也}
ziu3	tʃiu55	僬{僬僬},醮{打醮},詔{詔書，詔告},皭,照,炤{同照字},灂{車轅漆也},曌,嘦
ziu4	tʃiu21	劁{劁刈，劁豬},譙,瞧,潮,樵,朝{朝代，朝向；朝鮮，古讀陟遙切},晁,憔,嶕
ziu6	tʃiu22	兆,鮡,銚{放射性化學元素},趙,旐,噍{嚼},召{號召，密召，召見}
zo2	tʃo33	佐{輔佐，佐料},阻,詛{詛咒},左,岨{同阻字，險要},唨{粵字，咗的舊寫},咗{粵字，表完成，一說本字着/著，本地用了},俎
zo4	tʃo21	䠡{蹋聲},齹{齒根},鹺,鋤,鉏{同鋤字},酇{古縣名；白酒},蒫,矬{矮},瘥{病疫},痤
zo6	tʃo22	助,座,唑{咔唑，噻唑}
zoek2	tʃœk3	喌{(又)},足,蠋,蜀{(又)讀同燭},粥,竺,竹,祝,矚,瘃,燭,柷{柷敔},屬{(古)屬文，屬望；通囑字},囑{囑咐，遺囑}
zoek6	tʃœk2	妯,鏃,逐,軸,躅{躑躅},藚,舳,續,族
zoeng1	tʃœŋ53	㙡,鬷,鬃,騣,鐘{鬧鐘},鍾{鍾情，鍾愛},蹱{躘蹱},蹤,衷,螽,舯,腙,縱{縱橫},綜{綜合；織縷，古讀去聲},終,盅,琮{(又)},潨{崖岸},潀{同潨字},淙{(又)},樅{地名，樅陽（在安徽）},椶{椶色，椶櫚},棕{同椶字，棕色，棕櫚},柊,悰{(又)},忪{怔忪},忠,宗,倧,中{中間，當中},䁓{視也}
zoeng2	tʃœŋ33	傯,踵,腫,總,種{種類},种{同種字},熜{用麻莖捆扎成的火炬},摠,塚{(又)},冢{(又)}
zoeng3	tʃœŋ55	䝋{公豬},衆{衆多，大衆},縱{放縱},糉{糉子},粽{同糉字},種{種植},种{同種字},眾{同衆字},瘲{瘛瘲},偅,中{中計，打中；〈語〉動詞後表完成或曾經發生，𱤜（未曾）來～，還沒來，冇來～，沒來過}
zoeng4	tʃœŋ21	叢,重{重複，重新},賨,蟲,虫{同蟲字},藂,种{姓},琮,潨{水流匯合處},潀{同潨字},淙{淙淙},松{松樹，松子，松香，松柴（燒火用的松木）},悰,從{跟從；從容，古讀七恭切、書容切},崇
zoeng5	tʃœŋ24	重{輕重，重要，重病}
zoeng6	tʃœŋ22	仲{伯仲，仲裁；〈語〉副詞，還、仍，本字重},頌,重{副詞，還、仍，俗字仲},誦,訟,茽
zon1	tʃon53	鑽{(動)鑽研}
zon2	tʃon33	儹{(白)聚也},攢{(白)積攢}
zon3	tʃon55	鑽{(名)鑽子}
zon4	tʃon21	存,蹲{蹲蹲；蹲了腿},踆{踢}
zon6	tʃon22	攥{攥緊，攥拳，讀同纂},纘,纂{編纂，纂修}
zot3	tʃot5	㰵{(白)吮吸，～瀰[me21]，吸奶；吻，～嘴，親嘴}
zu1	tʃu53	租
zu2	tʃu33	珇,駔{駿馬},組,祖
zu3	tʃu55	做{做工，做人}
zu4	tʃu21	徂,殂
zu5	tʃu24	坐{坐車，請坐}
zu6	tʃu22	祚,阼,胙
zui1	tʃui53	䘒,騅,隹,錐{圓錐，鐵錐},追,脧{赤子陰},椎{椎骨，頸椎，椎子}
zui2	tʃui33	嘴{嘴巴，多嘴，瓶嘴},觜{鳥嘴},沝
zui3	tʃui55	㙍{地名用字},醉,蕞,綴{點綴，綴合},檇{檇李},最,晬,惴
zui4	tʃui21	捶,𢶀{損},𡃴{俗字，氣味，貶義，本字隨，避諱氣/棄，本地不用},鬌{髮落},隨{隨便，跟隨},隋,鎚,錘{鐵錘，秤錘},沝{(又)},槌{棒槌，鼓槌；拳～，拳頭},椎{同槌/捶字},棰,搥
zui6	tʃui22	墜,𢶀{拉，俗字拽},贅{累贅，贅言},膇,罪,縋,綴{(又)},拽{用力拉，本字𢶀},懟{(又)}
zuk2	tʃok3	䐁{臀；肥},諑{謠諑},琢{琢磨，雕琢},涿{地名，涿州、涿鹿（在河北）},椓,桌{桌面，書桌},晫,捉{捉拿，捕捉},卓{卓越，卓著},倬{顯著；大},䓬
zuk6	tʃok2	擢,鷟,灂{瀺灂},濯,濁,浞{水溼}
zun1	tʃun53	尊,鷷,鱒,鐏,遵,躦,繜,嶟
zun2	tʃun33	僔,撙,噂
zun4	tʃun21	攢{攢聚},欑
zung1	tʃoŋ53	樁
zung4	tʃoŋ21	噇,橦{竿},幢{人影幢幢，經幢}
zung6	tʃoŋ22	仲{(又)副詞，還、仍},漴,撞,憧{(白)笨；擔[tam55]～，蠢笨，～腏（戳物），笨蛋},幢{量詞}
zut2	tʃut3	撮{(又)}
zyu1	tʃy53	侏,雎,銖,邾,趄{趑趄},豬{豬肉，養豬},諸,誅,蛛,藷{藷蔗},葅,菹,茱,苴{苴麻},硃{硃砂，同朱砂},砠{同岨字},疽,珠{珍珠，珠算},狙,瀦,洙,沮{(古)沮水},櫫,櫧,株,朱{朱砂，朱漆；姓},岨{石山戴土},娵,姝
zyu2	tʃy33	主,齟,麈,鉏{鉏鋙},煮{煮飯，煮粥},煑{同煮字},渚,沮{沮喪，沮遏},枓{斟水器也},拄{拄柺杖},岨{岨峿},咀{咀嚼}
zyu3	tʃy55	沮{(古)沮洳},駐,鑄,註{註解},蛀{蛀牙，蛀蟲},著{著作，顯著},翥,疰,炷,注{注意}
zyu4	tʃy21	儲{儲蓄，儲備},𩿿,鶵,雛{雛形，鳳雛},除,鉏{古國名；姓},躕,躇,篨,滁,涂{水名，滁河},櫥,徐,廚
zyu5	tʃy24	佇,貯,詝,褚{姓},苧{苧麻},芧{同苧字},紵,竚,砫,楮,柱{樑柱，柱石；神～牌，神位、靈位},杼,拄{(又)讀同柱},宁{門屏之間}
zyu6	tʃy22	住,跙{行不進也},芧{橡樹或橡實},聚{聚會，凝聚},箸{下箸，箸籠；量詞},漵,敘{記敘，敘事},敍{同敘字},序,嶼{島嶼},垿
zyun1	tʃyn53	專,顓,鐫,膞{雞膞},耑{同專字},磚,氈{毛氈，氈帽},朘{縮減；剝削}
zyun2	tʃyn33	囀,𦟌,轉{轉移，轉送，旋轉},蹍,搌,展{展開，伸展},囅{(又)}
zyun3	tʃyn55	轉{轉動，公轉；轉彎，轉身，轉頭}
zyun4	tʃyn21	佺,鰁,銓,醛,遄,輇,跧,詮,荃,篅{盛穀具},筌,痊,瑔,牷,泉,椽{椽子},圌{同篅字},全,傳{傳達，宣傳，傳奇}
zyun6	tʃyn22	䉵,饌,譔,籑,篆,瑑,沌{水名},旋{(白)髮旋},撰,僝{具備},僎{具備},傳{傳記，自傳}
zyut2	tʃyt3	䇽,輟,踅{(訓)折回，訓讀折},裰,蜇{蜇人；海蜇（口語稱蜇皮）},蕝,茁,腏{骨間髓},絀,浙,歠,欼,梲{梁上短柱},晢,敠{(又)},掇{拾掇；掂掇},拙{拙作，笨拙，勤能補拙},折{折斷，打折；弄折了},惙,悊,喆,啜{喝；啜泣},哲,叕,剟
zyut6	tʃyt2	絕
